manipulation	manipulació
unsavory	desagradable
cozy	acollidor
brood	ramaderia
simplistic	simplista
achievements	èxits
invalidate	invalidar
jolt	sacsejada
sweeping	escombrant
acridness	acridesa
farcical	bromista
splendidly	esplèndidament
obsolete	obsolet
loved	estimat
flagging	marcat
erase	esborrar
adulatory	adulatori
slap	boig
hell-bent	immòbil
chivalry	cavalleria
manipulative	manipulador
opponent	oponent
loyal	lleial
worry	preocupació
hazardous	perillós
desirous	desitjós
evil	dolent
unsettling	inquietant
brilliance	brillantor
tarnishes	esmalta
crime	crim
unreadable	il·legible
renowned	reconegut
fidelity	fidelitat
malignant	maligne
disaffected	descontent
invidiousness	invalidesa
trustworthy	confiable
stalemate	estancament
scandels	escàndols
helping	ajudar
idiot	idiota
outrageousness	indignació
astounding	sorprenent
infringements	infraccions
loner	solitari
strictly	estrictament
despondence	desprenia
dies	mor
complemented	complementat
castigate	castigar
egregious	exagerat
fatuous	fatuós
stunning	impressionant
accomplishments	assoliments
cleaner	netejador
glare	resplendor
irking	tirar
blunt	despuntar
mirage	miratge
thoughtlessness	imprudència
flickering	parpelleig
refund	reemborsament
beauty	bellesa
mysterious	misteriós
aggressive	agressiu
adorer	adorador
grudging	rencor
appallingly	terriblement
unease	inquietud
rattles	sacsejades
likes	m'agrada
depress	deprimir
hostilities	hostilitats
limit	límit
alienation	alienació
charming	encantador
languorously	languidamente
meritorious	meritori
unnecessary	innecessari
dust	pols
restricted	restringit
discontinued	discontinuat
cheats	trampes
solace	consol
crushing	aixafament
distressingly	molestant
pleasure	plaer
tarnishing	tallar
worrying	preocupant
engulf	engolir
spacious	espaiós
begging	mendicitat
censure	censura
bickering	discutint
refuting	rebutjar
winnable	guanyable
steadfast	ferma
revert	reverteix
punishable	punible
enough	suficient
sublime	sublim
killed	morts
insightful	perspicaç
unruly	indisciplinat
impeccable	impecable
woefully	lamentablement
unprove	perdre
brazenness	descarada
sloppy	descuidat
avaricious	Àvid
qualms	ressenyes
diffidence	dificultat
awestruck	sorprès
trusted	confiat
illegal	il·legal
dissonance	dissonància
illicit	il·lícit
perturb	pertorbar
utterly	absolutament
tyrannical	tiràniques
distress	angoixa
guarantee	garantia
sickness	malaltia
astonishment	sorpresa
disconsolately	desconsoladament
overwhelm	aclaparat
amaze	sorprèn
retarded	retardat
insidiously	insidiosamente
childish	infantil
deceive	enganyar
support	suport
breakthroughs	avenços
premeditated	premeditada
dedicated	dedicat
profane	profà
terribly	terriblement
unaccessible	inaccessible
calamities	calamitats
harmed	ferit
anxiously	ansiosament
cheat	enganyar
anxiety	ansietat
damned	maleït
spellbound	embruixat
lively	animat
undercut	subcutit
demise	desaparició
immorality	immoralitat
throbbed	llàstima
chastise	castigar
horrendous	horrible
enchantingly	encantadorament
sobering	sobri
self-humiliation	auto-humiliació
revulsive	revulsiu
masters	mestres
insecurity	inseguretat
annihilation	aniquilació
offender	delinqüent
inculcate	inculcar
enjoying	gaudint
viciousness	viciosa
confess	confessar
rigidity	rigidesa
relentlessly	implacablement
lackeys	mancans
resolute	resolt
confounding	confondre
logical	lògic
inconsequentially	inconsecuentemente
invalidity	invalidesa
cracked	esquerdat
humour	humor
forbidding	prohibir
knock	copejar
harassed	hostigat
wildly	salvajemente
antagonist	antagonista
vestiges	vestigis
impressively	impressionants
disgusting	desagradable
dissension	dissensió
helpless	indefens
steeply	abruptament
smiles	somriu
miscreants	incomprensors
pitifully	lamentablement
standstill	parada
sensation	sensació
sporty	esportiu
litigious	litigiosos
dissapointed	decepcionat
screwed	cargolat
inhibition	inhibició
illusory	il·lusori
decency	decència
fierce	ferotge
wrath	ira
enrapt	embrague
cranky	cruixent
disapprove	rebutjar
starkly	cruelment
unjustified	injustificat
diabolical	diabòlic
trust	confiança
conceded	concedit
skepticism	escepticisme
glorify	glorificar
boisterous	boig
quandary	dilema
staunchness	agitat
beg	pregueu
inadequacy	insuficiència
affection	afecte
pampered	consentit
traitorously	traïdorament
foolish	neci
eventful	atroç
insidious	insidiosa
subsidizes	subvenciona
marginally	marginalment
aggression	agressió
hating	odiar
workable	factible
clouding	ennuvolat
inexplainable	inexplicable
reward	recompensa
corruption	corrupció
admiringly	admirablemente
favorite	favorit
enrichment	enriquiment
bizarre	estrany
rape	violació
unbelievably	increïblement
incorrigible	incorregible
meaningful	significatiu
accursed	maldestre
humane	humà
fearsome	temible
friendly	amable
unsustainable	insostenible
scolding	rega
ambiguity	ambigüitat
madness	bogeria
bribery	suborn
gloriously	gloriósament
scolded	regañat
weird	estrany
overzealously	excessivament
indecision	indecisió
degrading	degradant
longingly	ansiós
desertion	desertió
luxurious	luxós
considerate	considerat
criticize	criticar
leech	sangui
downcast	baixada
corruptted	corrupte
gleefully	alegrement
crafty	astut
impulsive	impulsiu
puzzlement	desconcertant
unjustifiable	injustificable
marvelled	meravellat
farfetched	despullat
opportunistic	oportunista
sue	demandar
unusable	inutilitzable
undamaged	intacte
insecure	insegur
wounds	ferides
impolitely	impolíticament
cynical	cínic
eager	ansiós
reforms	reformes
succeeding	triomfant
stinging	picada
acerbically	acerbicalment
revolutionizes	revoluciona
bleak	desolador
attentive	atent
hypocrites	hipòcrites
shock	xoc
crueler	cruel
misapprehend	malapprehend
abuses	abusos
unnatural	antinatural
horrify	horroritzar
capsize	capgirar
ebullient	exuberant
bent	inclinat
magnanimous	magnànim
lunatic	lunàtic
imprisonment	empresonament
empowerment	empoderament
endorse	avalen
smash	aixafar
choke	sufocar
cruelness	crueltat
spoiled	mimat
smile	somriure
ill-treated	maltractat
annoying	molest
erudite	erudit
exonerate	exonerar
winning	guanyador
warp	ur
laughable	risible
outlaw	prohibit
suffocate	asfixiarse
absurdity	absurd
influential	influent
impose	imposar
subjugation	submissió
wasteful	inútil
darling	estimat
envious	enveja
obscurity	obscuritat
shabby	lamentable
plebeian	plebeu
favour	favor
rebuke	reprensió
ambiguous	ambigu
omit	ometre
overstated	exagerat
creeps	arrels
enervate	enervar
deficiencies	deficiències
ailment	malaltia
sagged	enutjat
corrupted	corromput
skillfully	hàbilment
phenomenal	fenomenal
inaccurately	inexacta
destroyer	destructor
debilitate	debilitar
overrun	rebutjat
exceeded	superat
distorts	distorsiona
discrimination	discriminació
stability	estabilitat
excellence	excel·lència
poised	preparat
inferiority	inferioritat
illogically	il·lògicament
over-balanced	sobre-equilibrat
infected	infectats
combative	combativa
denounce	denunciar
evasion	evasió
inestimably	inestimable
love	amor
kindliness	bondat
controversial	controvertit
nauseate	nauseat
ineffective	ineficaç
fugitive	fugitiu
careless	descurat
vociferously	vociferant
insinuating	insinuant
lionhearted	lleonat
fortune	fortuna
enthrall	fascinant
inflated	inflat
overwhelms	aclapara
antagonistic	antagonista
lacks	manca
toil	treball
strange	estrany
fantastically	fantàsticament
suitable	adequat
divisiveness	divisivitat
regressive	regressiu
emaciated	emaciat
chaotic	caòtic
congratulate	felicito
threat	amenaça
charisma	carisma
deprived	privat
rejecting	rebutjant
euphorically	eufòricament
funnily	divertit
criticism	crítica
worthy	digne
respectful	respectuós
confused	confós
exaggerate	exagerar
advocates	advoca
struggling	lluitant
animosity	animositat
impartiality	imparcialitat
exagerated	exagerat
roomy	espaiós
beckoned	trucat
freeze	congelar
conspiratorial	conspiradora
delirium	deliri
shockingly	sorprenentment
womanizer	mujeriego
scrambled	revolts
farcically	fòricament
futility	inutilitat
cripples	parapents
direness	eressa
rampant	desenfrenat
nebulously	nebulós
stricken	afectat
passion	passió
subsidize	subvencionar
unusably	inusible
idiots	idiotes
solemn	solemne
imperfectly	imperfecta
prosper	prosperar
smart	intel·ligent
awesomely	increíblement
handsome	guapo
exhilarate	estimular
steep	empinat
dissent	dissidència
bereavement	dol
unfavorable	desfavorable
sparkle	espurna
misguided	equivocada
smells	olora
flaking	escamosa
inflammation	inflamació
altercation	altercació
instigators	instigadors
lengthy	llarg
brusque	brúsc
futuristic	futurista
improving	millorant
preoccupy	preocupació
fateful	fatídica
revolutionize	revolucionar
progressive	progressiu
defile	contaminar
revelation	revelació
jarring	nerviós
unilateralism	unilateralisme
uplifting	augmentant
peacefully	pacíficament
dispirited	despreciat
bastard	bastardo
superiority	superioritat
blundering	bloqueig
jittery	nerviós
refutation	refutació
zest	ronc
neurotically	neuroticament
exquisite	exquisit
flicker	parpelleig
overtaken	superat
crumble	desmoronar
unacceptable	inacceptable
courage	valentia
undependability	indedependència
lies	mentides
friendliness	amabilitat
shortage	escassetat
alarmed	alarmat
worried	preocupat
fuck	follar
ideally	idealment
amazed	sorprès
dissuasive	dissuasiu
illegally	il·legalment
irritation	irritació
steadfastness	fermesa
angrily	enfadat
thrive	prosperar
dead-on	mort-on
dissappointed	decepcionat
scorchingly	escumejant
hell	infern
shrug	ombrejat
tacky	enganxós
polished	polit
shortcomings	deficiències
grimace	ganyota
merciful	misericordiós
pardon	perdó
improves	millora
beneficent	beneficiós
breakups	ruptures
squeal	chill
exceedingly	exageradament
fiery	ardent
recovery	recuperació
nebulous	nebulós
amply	Àmpliament
dominated	dominat
succeeds	Èxit
plentiful	abundant
ineffectualness	ineficàcia
polluters	contaminants
flourish	florir
sting	picada
admonishment	amonestació
fascination	fascinació
sane	saludable
distracting	distreure
deservedly	merescudament
astonishingly	sorprenentment
inadvisable	desaconsellable
disloyalty	deslleialtat
impresses	impressiona
solidarity	solidaritat
zenith	cenit
thoughtfully	pensatiu
blurred	borrosa
disapointing	decepció
fleeting	fugaç
subsidized	subvencionat
fanatical	fanàtic
unsafe	insegur
insatiable	insaciable
sham	farsa
raptureous	còmic
isolated	aïllat
hoax	engany
losing	perdent
melancholy	malenconia
lawfully	legalment
angelic	angelical
jealousness	gelosia
insultingly	insultant
majestic	majestuós
upscale	exclusiu
perfunctory	perfunctoral
brash	boig
disagree	discrepar
enhance	millorar
unbelievable	increïble
romantic	romàntic
light-hearted	alegre
fatigue	fatiga
intimidating	intimidant
self-determination	autodeterminació
ineptly	ineptamente
sensational	sensacional
backwardness	endarreriment
fluster	gastador
manipulate	manipular
expired	vençut
motionless	immòbil
antithetical	antitètic
outstandingly	excepcionalment
refuted	rebutjat
bemoaning	lamentant
calumniously	calumniosamente
faithfulness	fidelitat
rumbling	rumorant
whore	puta
harmony	harmonia
snagging	enganxament
falsehood	falsedat
subtract	sostreure
mockery	burla
delayed	retardat
impudently	impudent
worn	desgastat
mortified	mortificat
gripe	malaltia
racism	racisme
demonizes	demoniza
objectionable	objetable
dexterous	destorós
gainful	guanyat
heresy	herejía
mournful	lamentable
hedge	coberta
unnervingly	incansablement
disillusions	desilusions
overdo	exagerar
mortifying	mortificant
disgusted	disgustat
anemic	anémico
undocumented	indocumentat
relentlessness	incansable
inhospitality	inhospitalitat
belittled	menystingut
torment	turment
hallowed	santificat
illiterate	analfabets
praiseworthy	lloable
blessing	benedicció
sweaty	suat
collude	enojo
breakthrough	avenç
prudence	prudència
spurn	espurnes
invincibility	invencibilitat
ambitious	ambiciós
blasphemous	blasfem
upgraded	actualitzat
dejection	dejecció
demolisher	demoledor
thwart	frustrar
amiable	amable
enjoyably	agradablement
inordinately	inordinadament
beneficial	beneficiós
inhumane	inhumà
infuriate	enfuriar
excellently	excel·lentment
perplexity	perplexitat
fearful	temorós
compulsion	compulsió
fawningly	adolorit
rascals	bessons
frightful	espantós
cold	fred
interfere	interferir
limits	límits
messy	desordenat
shine	brillar
ineligible	inelegible
superficially	superficialment
fatefully	afectuosament
fragmented	fragmentat
supreme	suprem
biting	mossegar
pervert	pervertit
illumine	il·luminar
eccentric	excèntric
rattle	trampa
laconic	lacónico
congested	congestionat
fraud	frau
impossiblity	impossibilitat
destitution	destitució
conservative	conservador
brazenly	descaradament
mercy	gràcies
shortsightedness	miopia
condemned	condemnat
dumbfounded	immòbil
exemplary	exemplar
spoon-feed	cullera
survival	supervivència
fucking	follant
bewilder	desconcertant
clogs	esclops
wins	guanya
self-criticism	autocrítica
decayed	decadent
dispirit	desmentit
spook	espectacle
festive	festiu
dismally	desmamós
denies	nega
insufficient	insuficient
outbreak	esclat
confidence	confiança
adversary	adversari
stabilize	estabilitzar
worrisome	preocupant
lovely	preciosa
spectacularly	espectacularment
falsify	falsificar
breeze	brisa
irritably	irritablement
vomiting	vòmits
offenses	delictes
admirably	admirablement
desolately	desolat
dogmatic	dogmàtic
condemnation	condemna
miscreant	incomprensible
deluge	diluvi
suicidal	suïcida
bore	avorrit
hypocrisy	hipocresia
ineptitude	ineptitud
dropouts	abandonaments
frenetic	frenètic
richness	riquesa
bother	molesteu
lunaticism	lunaticisme
tantalize	tantalitzar
meddle	entrometerse
extravagance	extravagància
naive	ingenu
unappealing	desagradable
gimmicks	trucs
jitters	nervis
dismayed	consternat
trample	trepitjar
unparalleled	inigualable
fancy	luxós
heroically	heroicament
awfully	terriblement
incommensurate	incommensurable
versatility	versatilitat
disappointments	decepcions
deference	deferència
monstrous	monstruós
gratify	gratificar
credulous	credulós
fastuous	fastuós
well-being	benestar
dictator	dictador
obstructs	obstaculitza
quack	chack
friction	fricció
fussy	llepafils
strong	fort
limp	boig
subservient	subordinat
deceptively	enganyosament
despairingly	desesperadament
depraved	depravat
monstrously	monstruós
bothering	molestant
indiscriminately	indiscriminadament
harasses	assetja
imaginary	imaginari
commendable	encomiable
darkened	enfosquit
gruff	horrible
illogic	il·lògic
scratchy	raspadat
procrastinate	retardar
bonuses	bonificacions
blistering	ampolla
maliciousness	malícia
liberty	llibertat
crap	merda
disown	rebutjar
heartfelt	sincera
downturn	desacceleració
elimination	eliminació
desirable	desitjable
tangle	enredar
laughably	ridícul
horde	horda
overture	obertura
evils	mals
intimidate	intimidar
suppress	suprimir
disappointment	decepció
famous	famós
fascism	fascisme
precariously	precariamente
saintliness	santedat
polemize	polemitzar
jeering	embruixat
delirious	delirant
astounded	sorprès
wound	ferida
mockeries	burla
cruelties	crueltat
recourses	recurs
bothers	molesta
bias	parcialitat
pleas	mots
advantageous	avantatjós
bewilderment	desconcert
destructive	destructiu
unleash	alliberar
unnaturally	desnatural
inelegance	inelegància
cooperatively	cooperativament
attractively	atractivament
suspect	sospitós
calumniation	calumnia
irrationality	irracionalitat
assuredly	segurament
unsettled	inestable
upsetting	molestant
frictions	friccions
vomit	vòmit
perplexing	perplex
deteriorating	deteriorant-se
detachable	desmuntable
agile	Àgil
tense	tens
confined	confinat
deceitfulness	engany
writhe	escriu
disorder	trastorn
famously	famós
blissfully	feliçment
enraged	enfurismat
intelligence	intel·ligència
decrepitude	decrepitud
remarkably	notablement
deign	dignitar
loathsomely	ofensivament
stun	atordiment
corrosive	corrosiu
smug	presumible
dauntless	indolent
abominably	abominablement
stumped	estonat
harassment	assetjament
critics	crítics
unseemly	indegudament
retreat	retir
exasperation	exasperació
hectic	frenètic
funny	divertida
endearing	entranyable
exhausts	escapes
stumps	tocs
protection	protecció
inconceivably	inconcebiblement
languish	languidece
ineffectiveness	ineficàcia
refusing	refusant
celebratory	celebració
distortion	distorsió
manageable	manejable
degenerately	degeneradament
peevishly	nerviosament
despondent	desanimat
amazingly	sorprenentment
trump	triomf
chaste	cast
shameful	vergonyós
fertile	fèrtil
admonition	admonició
seething	estiramiento
fondness	afecte
lurid	escabrosos
stimulates	estimula
shamelessness	desvergonyiment
unkindly	incansablement
losses	pèrdues
hypocritically	hipòcritament
asinine	asinina
appreciative	agraït
demonized	demonitzat
slow	lent
hazy	nebulós
screwy	atornillat
convenience	comoditat
unable	incapaç
overstate	exagerar
lazy	mandrós
fanatic	fanàtic
picky	exigent
mocked	burlat
demoralize	desmoralitzar
irreconcilable	irreconciliable
troublesomely	molestos
ecstatically	ecstàticament
hardy	resistent
greatness	grandesa
hypocritical	hipòcrita
energetic	enèrgic
regretted	lamentat
caustic	càustic
soreness	dolor
loot	botí
wretch	desgraciat
displeased	descontent
degrade	degradar
wobbles	llança
haggard	enganyat
mystify	mistificar
dextrous	dextro
heavyhearted	pesat
avidly	Àvidament
subpoena	citació
loving	estimant
disdained	menyspreat
upliftingly	augmentant
self-sufficient	autosuficient
sluggish	lenta
contemptuous	despectiu
detested	detestat
scams	estafes
intuitive	intuïtiu
patronize	patrocinar
deploring	deploració
ramshackle	embotellat
cloud	núvol
stereotypical	estereotípic
fallacious	fallida
discrepant	discrepants
bug	error
knife	ganivet
unconditional	incondicional
obsession	obsessió
lacked	faltava
incoherence	incoherència
implication	implicació
illusions	il·lusions
reforming	reformes
prefer	preferir
thrift	bestiar
treason	traïció
altruistic	altruista
incomprehension	incomprensió
devilry	diable
fallacy	fal·làcia
traumatically	traumàticament
groundbreaking	innovador
inefficacy	ineficàcia
alluringly	fascinant
euphoria	eufòria
involuntary	involuntari
displace	desplaçar
regress	tornada
goofy	torrat
deformed	deformat
frantically	frenèticament
poeticize	poetitzar
inadequate	inadequat
tamper	manipulador
disorient	desorient
hug	abraçada
liar	mentir
terribleness	terribleitat
plague	plaga
matte	mat
frenetically	frenèticament
joy	alegria
sack	sac
feeblely	feble
disparaging	despectiva
ingenuously	ingenuament
contend	contestar
autocratic	autocràtic
exaltingly	exaltant
unworthy	indigne
weakening	debilitament
enticing	atractiu
idealize	idealitzar
mischievously	maliciosament
collapse	col.lapse
trapped	atrapat
convoluted	complicat
flickers	parpelleja
dump	bolcat
contentious	controvertit
unexplained	inexplicable
drips	gotes
desiccated	dessecat
stainless	inoxidable
pride	orgull
sardonically	sardònicament
garbage	escombraries
disunity	desunió
dumb	mut
ulterior	posterior
repulsed	rebutjat
congenial	agradable
condemn	condemnar
illusion	il·lusió
clash	xoc
intelligible	intel·ligible
nuisance	molèstia
sweeten	endolceix
irredeemable	irredible
wearisome	cansat
incredulous	incrèdul
flake	escamas
dismay	consternació
wariness	cautela
hospitable	hospitalari
choleric	colérico
exasperated	exasperat
irately	irat
amenity	comoditat
brutalizing	brutalitzant
enlighten	il·luminar
punch	punxó
mind-blowing	molestia
deceitfully	enganyosa
pains	dolors
doubtfully	dubtós
clears	esborra
remorse	remordiment
fuss	escàndol
fanatically	fanàticament
worsening	empitjorament
retract	retractar
vicious	cruel
healthy	saludable
condemns	condemna
scarily	escassament
complicit	còmplice
muddy	fangós
bumping	cops
magnanimously	magnànimament
miserly	miserable
receptive	receptiu
rile	trastorn
misunderstanding	malentès
pariah	paria
restriction	restricció
plunder	saqueig
distressing	molestant
innovative	innovador
vice	vici
idiocy	idiotes
thoughtful	pensatiu
gossip	xafarderies
intrusive	intrusiu
oddities	estranyes
taboo	tabú
delighted	encantat
dense	dens
promises	promeses
frustrated	frustrat
fabulously	fabulós
shrill	estrident
revengeful	revenja
pry	picar
plaything	juguetear
fat	greix
selective	selectiu
appropriate	apropiat
dejected	expulsat
remorselessness	remorderança
undetermined	indeterminat
slander	calúmnia
satisfied	satisfet
appealing	atractiu
scant	escàs
traitor	traïdor
battered	maltractat
renewed	renovat
damper	amortidor
diplomatic	diplomàtic
tetchily	típiques
twist	gir
omission	omissió
sumptuously	sumptuosament
flawed	defectuós
uncompromising	intransigent
impiety	impietat
refute	refutar
strained	tensió
rotten	podrit
stark	crua
successes	Èxits
unimaginable	inimaginable
squealing	xafant
pepped	atrapat
rivalry	rivalitat
sporadic	esporàdic
horrid	horrible
interests	interessos
leak	fugida
infallibly	infaliblement
defamations	defamacions
proactive	proactiu
pleasingly	agradablement
attractive	atractiu
scarred	cicatritzat
demoralizing	desmoralitzant
rejoice	alegra't
expel	expulsar
iniquitous	inicuos
wealthy	rics
petrify	petrificar
inconveniently	inconvenientment
bloated	inflat
blameworthy	incomprensible
junk	escombraries
tempt	temptejar
hegemony	hegemonia
right	dret
disdainful	menyspreable
inflame	inflama
impatience	impaciència
stunningly	sorprenentment
unjust	injust
belittling	menyspreu
youthful	juvenil
subvert	subvertir
negatives	negatius
revitalize	revitalitzar
amity	amistat
apathetic	apàtic
allergy	al·lèrgia
eminence	eminència
dubiously	dubtós
dazed	atordit
generous	generós
impossibly	impossiblement
scratch	rascar
anti-israeli	anti-israelians
delightful	encantador
immense	immens
falling	caient
golden	daurat
vindictive	venjatiu
defeats	derrotes
startle	sorpresa
loophole	llacuna
tremendously	tremendament
greasy	greixós
dawn	alba
unaffordable	inaccessible
curses	malediccions
upliftment	elevació
erratically	erràticament
mighty	poderós
audaciousness	audàcia
totalitarian	totalitaris
thank	gràcies
courageously	valent
brilliantly	brillantament
prisoner	pres
skeptically	escèpticament
lucky	afortunat
absurdness	absurd
unfriendly	hostil
conspicuous	conspicu
chunky	picant
denying	negant
unreachable	inaccessible
realizable	realitzable
bearish	baixista
majesty	majestat
deter	dissuadir
tyrant	tirà
stern	popa
naughty	travieso
scandalously	escandalós
rot	podridura
expansive	expansiu
favorited	favorit
disproportionate	desproporcionat
anti-social	antisocial
clever	intel·ligent
hassle	molèsties
disgraced	desgraciat
misgivings	dubtes
scornfully	despreocupadament
downgrade	rebaixa
principled	principis
passionately	apassionadament
frustrating	frustrant
reprimand	reprimenda
unuseable	inutilitzable
grainy	granulat
break-ups	ruptures
sorrow	pena
tin-y	tin-i
unrelentingly	incansablement
shroud	morta
soapy	sabó
shimmering	brillantor
stab	apunyalar
marvellous	meravellós
cliche	clixé
authoritarian	autoritari
impudence	impudència
recession	recessió
offence	delicte
unforeseen	imprevist
maniac	maníac
irragularity	irracularitat
poisonous	verinós
outwit	sorprendre
lackadaisical	faltaadaisical
irrelevance	irrelevancia
doom	destrucció
despicably	despreciablement
arbitrary	arbitrari
proficient	competent
finest	millor
pleasing	agradable
dissed	disseca
offensive	ofensiu
glad	alegre
gullible	engreixable
detrimental	perjudicial
shocked	sorprès
evaluative	avaluatiu
speedily	ràpidament
invidious	inadequat
afflict	aflicció
mysteriously	misteriosament
triumphantly	triomfant
downside	avall
reclaim	recuperar
measly	miserable
chagrin	disgust
freezing	congelació
severe	severa
unraveled	desenfrenat
anarchistic	anarquista
stains	taques
blasphemy	blasfèmia
stuttering	tartamudesa
strangely	estranyament
creak	crek
foolishness	insensatesa
blasted	picat
hardship	dificultats
unlamentably	inequívocament
wisdom	saviesa
distinction	distinció
aweful	sorollós
wrinkle	arruga
resentment	ressentiment
humility	humilitat
misunderstood	incomprendido
oblique	oblic
aghast	agotar
misreading	falsificació
misses	falla
burned	cremat
murderously	assassinat
sticky	enganxós
irrationals	irracionals
commend	felicitar
flair	estil
bleed	sagnar
trivially	trivialment
aspiration	aspiració
lacking	mancat
vomited	vomitat
messed	embolicat
fake	fals
interesting	interessant
maddening	enloobant
flout	rebutjar
sidetracked	desviat
accessable	accessible
humiliation	humiliació
magic	màgia
adventuresome	aventurer
stiffness	rigidesa
complacent	complaent
inexpert	inexperts
faint	feble
vouch	aval
troublesome	problemàtic
standout	destacat
instable	inestable
trash	escombraries
conceit	presumir
hallucination	al·lucinació
disloyal	deslleial
complain	queixar-se
argumentative	argumentatiu
ergonomical	ergonòmic
smack	cop
untouched	intacte
easing	alleujament
upset	molest
aborted	avortat
thorny	espinós
traduce	traduir
oddly	estranyament
excel	sobresortir
prick	picar
blurry	borrós
disturbingly	inquietant
steal	robar
dripping	degoteig
exterminate	exterminar
pessimism	pessimisme
irrecoverablenesses	irrecuperables
fatalistically	fatalísticament
sneer	espiar-se
rejuvenated	rejovenit
reassure	tranquil·litzar
unnerved	nerviós
discredit	descrèdit
hubris	boig
lavish	luxós
gangster	mafiós
ambitiously	ambiciós
squash	carabasseta
counter-productive	contraproduent
joyous	alegre
partiality	parcialitat
junkyard	ferralla
grating	reixeta
uncontrolled	descontrolada
blandish	descarat
soundness	solidesa
reverently	reverència
incautious	incrèdul
gained	guanyat
inactive	inactiu
bonus	bonificació
enraging	enfuriant-se
resurgent	ressorgir
dignified	digna
difficulties	dificultats
dissembler	dissemblador
undermined	soscavat
grievous	dolent
disastrous	desastrós
spoil	espatllar
emergency	emergència
glory	glòria
instructive	instructiu
disrespectablity	desespectabilitat
cheap	barat
indeterminably	indeterminadament
melodramatic	melodramàtic
winners	guanyadors
squeaky	esgarrifós
disquietingly	inquietantment
jealous	gelós
oblivious	oblidat
sadden	trist
ingratitude	ingratitud
exploitation	explotació
infest	infesta
whining	ploriqueig
terrifically	terriblement
eye-catching	cridaner
belie	desmentir
equitable	equitatiu
harrow	rampa
negate	negar
desperation	desesperació
ruin	ruïna
flakieness	fluïdesa
spectacular	espectacular
distrust	desconfiança
disapointed	decebut
compact	compacte
dissatisfies	descontents
shortness	falta
fatally	fatalment
prettily	preciósament
charmingly	encantadorament
impurity	impuresa
deterioration	deteriorament
harangue	arengue
denied	negat
impede	impedir
slashing	tallant
mistake	errada
optimism	optimisme
denial	negació
exceed	superar
gifted	dotada
waning	disminuint
regreted	lamentat
reliable	fiable
exploit	explotar
scarcity	escassetat
tension	tensió
selfish	egoista
manic	maníac
convincingly	convincent
traumatic	traumàtic
honoring	honorar
sadness	tristesa
haughty	altíssim
sly	astut
amiss	malament
bewildering	desconcertant
discomfort	incomoditat
reverence	reverència
pillage	pillatge
despotism	despotisme
disintegration	desintegració
serene	serè
revolting	revoltant
paradoxical	paradoxal
mobster	mafiós
heartwarming	ardent
denunciate	denunciar
gratified	satisfet
courtly	cortesana
positive	positiu
frustration	frustració
conciliatory	conciliador
struck	copejat
troublemaker	problemàtic
preposterously	absolutament
debility	debilitat
exhort	exhortar
snub	desenfrenat
endorsing	aval
waste	malbaratament
ghetto	gueto
detraction	detracció
monster	monstre
saintly	sant
scream	crit
entrust	confiar
oppression	opressió
consummate	consumat
realistic	realista
imposing	imposant
sneakily	sorollosament
lovable	amable
upseting	molestant
boycott	boicot
exciting	emocionant
teasingly	exageradament
bleakness	descoratjament
honesty	honestedat
maledict	maledicció
saint	sant
hum	brunzit
sneak	colar-se
brotherly	fraternal
swamped	inundat
aggrivation	agressivitat
fractiously	fracturalment
chastisement	castigament
courageous	valent
calamitous	calamitoso
overbalance	sobrebalance
devastating	devastador
dissidence	dissidència
bullyingly	bulliciós
slug	escletxa
floored	sòl
negative	negatiu
phobic	fòbic
indignity	indignitat
despondency	desanimació
frigid	frigida
brittle	trencadís
credence	credibilitat
inadverently	inadvertidament
prudently	prudentment
reluctant	reticent
ferocity	ferocitat
deluded	enganyat
scorching	escumejant
dissocial	dissociador
enticed	seduït
serenity	serenitat
cackle	xerra
caustically	caòticament
suspiciously	sospitosament
blissful	feliç
annoy	molestar
insignificance	insignificància
devious	desviat
bountiful	abundant
abysmally	abismalment
convience	conveniència
messes	embolics
better	millor
ire	ira
redemption	redempció
malcontented	malcontentat
repress	reprimir
thankful	agraït
enchanting	encantador
squander	desperdiciar
blemish	defecte
expropriate	expropiat
trap	trampa
shimmer	brillo
encouragingly	encoratjadorament
irritations	irritacions
recomend	recomana
stinks	pudor
wripping	trencant
smallish	petitíssima
unity	unitat
exellent	excel·lent
runaway	fugitiu
ruining	arruïnant
catastrophically	catastròficament
limitation	limitació
havoc	estralls
indecently	indecent
uplift	aixecament
unintelligible	inintel·ligible
meticulous	meticulós
merriment	alegria
flat-out	pla
unusually	inusual
betray	trair
concern	inquietud
unstable	inestable
uproarous	allau
conveniently	convenientment
fruitless	infructuós
arrogance	arrogància
fiendish	diabòlic
pitiful	lamentable
rectifying	rectificació
sued	demandat
embroilment	embriatge
melodramatically	melodramàticament
defective	defectuós
bankrupt	fallida
raked	rastellat
triumphant	triomfant
diligence	diligència
timid	tímid
mire	mira
blockhead	bloqueig
detracts	disminueix
loser	perdedor
stylized	estilitzat
inconceivable	inconcebible
inexpensive	barat
disorderly	desordenat
dashing	corrent
impulsively	impulsivament
infamously	infamamente
indignantly	indignat
concise	concisa
welcome	benvinguda
pleases	agrada
defunct	desaparegut
blatantly	descaradament
discontentedly	descontentament
barbarity	barbaritat
virulence	virulència
exacerbate	empitjorar
miraculous	miraculós
disreputable	indescriptible
admiration	admiració
fabrication	fabricació
guilty	culpable
prejudge	prejudicar
nepotism	nepotisme
harmless	inofensiu
blurs	desdibuixat
inhibit	inhibir
bafflement	malestar
nervously	nerviosament
barbaric	bàrbar
defamation	difamació
destiny	destí
incendiary	incendiari
readily	fàcilment
authoritative	autoritari
razor-sharp	afilat
overtakes	avança
poor	pobre
confusion	confusió
doddering	esquarterant
intimacy	intimitat
surpass	superar
indecisively	indecís
hazard	perill
grievances	greuges
fresh	fresc
anxieties	ansietats
impoverish	empobriment
hasseling	molestia
stupify	estupir
hurts	dol
disbelief	incredulitat
spewed	llançant
bravado	bravat
loud	fort
stodgy	imprudent
confrontation	confrontació
violently	violentament
painless	indolor
brazen	descarat
bashing	colpejant
depressed	deprimit
disgustfully	desagradable
dark	fosc
cruelty	crueltat
fails	falla
recklessness	imprudència
horrifies	horroritza
twisted	retorçat
repression	repressió
forgetfulness	oblit
improvement	millora
panic	pànic
disagreeable	desagradable
torturous	tortuosos
subversion	subversió
mortify	mortificar
stump	tocón
feverish	febril
adore	adorar
destitute	indigent
hobble	aficionat
electrify	electrificar
affable	afable
siege	cèrcol
feebleminded	feble
sinking	enfonsament
falsely	falsament
auspicious	auspicis
distinctive	distintiu
outrageous	escandalosament
insurrection	insurrecció
unfeeling	indecent
dumbfound	immòbil
contradict	contradiu
disconcerting	desconcertant
awe	por
regard	respecte
profoundly	profundament
busybody	ocupat
comforting	reconfortant
spank	assotar
puppet	titella
expropriation	expropiació
skill	habilitat
alarm	alarma
panicky	pànic
obscure	fosca
resistance	resistència
disruptive	pertorbador
bulkyness	voluminosa
pertinacity	pertinacitat
glowingly	bruscament
startlingly	sorprenentment
pleasurable	plaent
profusion	profusió
corrosion	corrosió
intermittent	intermitent
tricky	difícil
sharp	agut
mesmerizingly	sorprenentment
unpopular	impopular
hampered	obstaculitzat
losers	perdedors
felicitate	felicitar
recommendation	recomanació
goon	continuar
distains	dissenya
despotic	despòtic
volatile	volàtil
steadfastly	fermament
contribution	aportació
poorly	malament
phenomenally	fenomenalment
clogged	atrapat
disquietude	inquietud
crowdedness	multitud
whips	fuets
bugging	molestant
exalted	exaltada
lavishly	esplèndidament
rightness	rectitud
wripped	embolicat
abnormal	anormal
dissonantly	dissonant
craftly	artesanalment
ethical	ètic
dreadful	terrible
inessential	inesencial
congratulatory	felicitacions
upsettingly	atroç
arduous	ardu
despair	desesperació
thoughtfulness	reflexió
emptiness	buit
courageousness	valentia
unjustly	injustament
invaluablely	invalorablement
catastrophies	catàstrofes
prodigy	prodigi
supporting	suport
shamefully	vergonyosament
sweet	dolç
idiotic	idiota
growl	créixer
panoramic	panoràmica
despise	menysprear
smitten	ferit
slanders	calúmnia
award	premi
smoke	fum
overstatements	exageracions
loose	solt
rapturously	bojosament
persecute	perseguir
overjoyed	alegre
incorrectly	incorrectament
burn	cremar
disadvantaged	desfavorits
calumnious	calumnia
weakness	debilitat
defiant	desafiant
stutters	estribos
stranger	desconegut
cry	plorar
dizzing	endiablant
reluctantly	contracor
calming	calmant
declines	disminueix
indelicate	indelicat
afflictive	aflicció
taunts	burla
erosion	erosió
slanderous	calúmnia
richly	ricament
prejudice	prejudici
indebted	deutor
trumpet	trompeta
demonic	demoníac
displaced	desplaçats
vomits	vomita
infuriated	enfuriat
breakup	trencar
challenging	desafiant
ecstatic	extático
scathingly	mordaçment
sloww	retardar
gratitude	gratitud
seriousness	serietat
embarrass	avergonyir
deteriorate	deteriorar
contortions	contorsions
madden	boig
skittish	descoratjador
gem	gemma
dehumanize	deshumanitzar
sufficient	suficient
holy	sant
abuse	abús
licentious	llicenciat
recoil	retrocés
penalize	penalitzar
feeble	feble
correctly	correctament
impeccably	impecable
superstitious	supersticiosos
counter-attack	contraatac
stringent	rigorós
cohesive	cohesiu
villianous	villanos
regally	regalment
avariciously	avariament
insinuation	insinuació
tranquility	tranquilitat
excitedness	excitat
bliss	felicitat
infuriating	enfuriant
poetic	poètic
fortunate	afortunat
concede	concedir
wretched	miserable
alluring	fascinant
shaky	inestable
blatant	flagrant
nimble	àgil
lose	perdre
dependable	confiable
reprovingly	reprobant
overturn	bolcat
satisified	satisfet
exalt	exaltar
sabotage	sabotatge
scoldingly	gratament
bloom	florir
implicate	implicar
danger	perill
disquieting	inquietant
discordance	discordança
audacious	audaç
flawless	impecable
haste	pressa
scratched	ratllat
smudge	manchú
uncivilized	incivilitzat
accusation	acusació
brisk	ràpid
calmness	calma
stupidity	estupidesa
hypocricy	hipocresia
lag	retard
integrated	integrat
gross	brut
hegemonistic	hegemonista
enviably	enviablement
troubled	preocupat
unlawfulness	il·legalitat
crazily	bojos
fool	ximple
impartial	imparcial
illuminati	il·luminats
stupor	estupor
misleadingly	enganyosa
recommendations	recomanacions
petrified	petrificat
pure	pur
heaven	cel
apocalyptic	apocalíptic
monstrosities	monstruositats
beneficially	beneficiós
fancinating	fancinant
leading	líder
intrigue	intriga
disgraceful	vergonyós
scandalize	escandalitzar
protest	protesta
distrustful	desconcertant
grind	moldre
glimmer	brillantor
overloaded	sobrecarregat
perfidity	perfidesa
glaringly	clarament
cherub	querubí
crazy	boig
counterproductive	contraproduent
revile	reviure
villainous	vilà
frost	gelades
stale	obsolet
sick	malalt
inescapable	ineludible
pretentious	pretensiós
villian	vilà
ridicule	ridícul
stain	taca
lie	mentir
burning	crema
astonished	sorprès
contempt	menyspreu
appreciated	apreciat
contemptible	despreciable
obstruction	obstrucció
boiling	bullint
humourous	chistós
archaic	arcaic
hamper	dificultar
pluses	avantatges
satisfying	satisfacció
disrupt	interrompre
pigs	porcs
invader	invasor
inconsistence	inconsistència
inconsiderate	desconsiderat
lukewarm	tebi
glistening	brillantor
stammer	balbucejar
fickle	inconstante
invigorate	dinamitzar
imperiously	imperiosamente
playful	juganer
baffling	desconcertant
handicapped	discapacitats
pollute	contamina
faults	falles
revoke	revocar
simplified	simplificat
monotonous	monòton
excelled	sobresortit
rectification	rectificació
agreeable	agradable
inaction	inacció
busts	bustos
reprehensibly	reprensiblement
onslaught	emboscada
shrouded	embolicat
rebellious	rebel
temptation	temptació
insufferable	insuportable
irritated	irritat
overbearing	superació
sink	pica
unthinkably	impensable
lonely	solitari
demonize	demonitzar
harboring	acollint
amuse	divertir
alarmingly	alarmant
tenuous	tènue
scorn	menyspreu
indistinguishable	indistinguible
interruptions	interrupcions
undercuts	baixades
slogged	inclinat
bitterness	amargor
reluctance	reticència
prestige	prestigi
indeterminate	indeterminat
absentee	absent
toxic	tòxic
stereotypically	estereotipada
hysteric	histèrica
steals	roben
blockage	bloqueig
confident	confiat
sincere	sincer
ruins	ruïnes
admonish	adverteix
scourge	plaga
discouragement	desànim
adaptive	adaptatiu
drawbacks	inconvenients
smooth	llis
missed	perduda
generously	generosament
disasterous	desastre
irrational	irracional
sorrowful	trist
inconsequential	inconsecuente
problem	problema
smilingly	somrient
prickle	picada
bullies	valents
nemesis	némesis
disinterested	desinteressat
emphatically	enfáticamente
miraculousness	miraculosa
difficult	difícil
menacingly	amenaçadorament
downsides	desavantatges
optimal	Òptima
criticizing	criticant
harass	assetjar
antagonize	antagonitzar
jubilation	jubilació
stable	estable
belligerent	bel·ligerant
successful	reeixit
dying	morint
ironical	irònic
proves	prova
capriciously	capritxosa
bumped	atacat
reprehensive	reprensiu
seasoned	sazonat
obliterate	esborrar
inexperience	inexperiencia
eloquence	eloqüència
pretty	bonic
stagnation	estancament
aggressor	agressor
bunk	llitera
explode	explotar
ludicrously	ridícul
setback	revés
extortion	extorsió
fun	diversió
direly	terriblement
atrocities	atrocitats
provoke	provocar
hothouse	hivernacle
drastically	dràsticament
painfully	dolorosament
heathen	pagans
taint	taca
gritty	amarg
bitterly	amargament
contaminated	contaminat
wanton	desitjada
deviate	desviar-se
evade	evadir
injure	ferir
panicking	pànic
champion	campió
gracious	amable
stereotype	estereotip
quash	esborra
self-defeating	autodestructiva
dogged	perseguit
fractious	fracturals
sensations	sensacions
happily	feliçment
discompose	descompondre
indifferent	indiferent
clearly	clarament
ungrateful	ingrat
inconsolably	inconsolable
villains	vilans
crumpled	arrugat
damn	maleïda
noisy	sorollós
shrivel	rebuig
harsh	dures
unhappiness	infelicitat
conspiracy	conspiració
reasonably	raonablement
pessimistically	pessimista
venerate	venerar
amicable	amistós
startling	sorprenent
hissed	silenciat
restrict	restringir
unachievable	inassolible
implode	implosió
avid	àvid
navigable	navegable
paramount	primordial
impure	impur
overheat	sobreescalfament
viciously	cruelment
perverse	pervers
itching	picor
frustrate	frustrar
tingle	formiguejar
elevate	elevar
leads	condueix
daze	atordit
adversarial	adversarietat
affordably	assequible
cannibal	caníbal
dissing	dissuadir
surmount	superar
scandel	escàndol
incompatability	incompatibilitat
bulky	voluminós
immorally	immoralment
overstates	exageració
venomous	venenoso
unbearable	insuportable
clumsy	torpe
mislead	enganyar
sleek	pulcre
explosive	explosiu
exhorbitant	exorbitant
horrifys	horrorosos
helped	ajudat
promising	prometedor
windfall	imprevist
loss	pèrdua
endorsed	aprovat
infallibility	infal·libilitat
exorbitantance	exorbitant
outdone	obsolet
revives	ressuscita
stunted	atordit
unavoidably	inevitablement
contemptuously	despectivament
brilliant	genial
glitch	error
interrupt	interrompre
eagerly	ansiosament
beneficiary	beneficiari
smudging	manchú
loses	perd
truthfulness	veracitat
scare	espantar
lascivious	lescivia
approval	aprovació
touted	promocionat
scornful	menyspreable
profound	profund
notably	notablement
shun	rebuig
ambush	emboscada
remarkable	notable
parody	paròdia
mourn	plorar
tiring	cansador
debatable	discutible
fumes	fums
jeopardy	perill
unreal	irreal
upbeat	optimista
enhancement	millora
reconciliation	reconciliació
amazement	sorpresa
diametrically	diametralment
rejuvenate	rejovenir
accuse	acusar
miscellaneous	divers
illogical	il·lògic
disillusioned	desencantat
misunderstand	malentendre
diabolically	diabòlicament
fascist	fascista
lucidly	lúcidament
drawback	inconvenient
irrecoverableness	irrecuperable
paralize	paralitzar
annoyances	molèsties
indiscreet	indiscret
defiantly	desafiant
nastily	desagradablement
impetuously	impetuosament
liked	agradat
hypocrite	hipòcrita
crash	falla
recessionary	recessiu
bleakly	desagradable
rogue	deshonor
unfaithfully	infidel
gentle	amable
concerns	preocupacions
shit	merda
adulterier	adúlter
facilitate	facilitar
peaceful	pacífic
peppy	picant
nourishment	alimentació
cramping	calambres
spoilled	esmunyit
believeable	creïble
barbarically	bàrbarament
brutality	brutalitat
doubtful	dubtós
inflict	infligir
immoderately	inmoderadament
straighten	redreçar
distasteful	desagradable
breach	incompliment
unexpectedly	inesperadament
mawkish	francs
best	millor
sarcastic	sarcàstic
envy	enveja
oddity	estranyesa
chivalrous	caballeresc
hasty	precipitada
break	trencar
saver	estalviador
satisfy	satisfacció
crooks	bandits
vengefulness	venjança
oversimplified	simplificat
hoodwink	encantat
faithful	fidels
wedge	falca
insurmountable	insuperable
enthuse	entusiasmar
neatly	perfectament
eruptions	erupcions
unequivocally	inequívocament
regret	lamenta
scramble	lluita
ragged	rosses
proud	orgullós
unsound	inadequat
barbarian	bàrbar
ferociously	feroçment
undisputably	indiscutiblement
exultingly	exultantemente
sad	trist
tanks	dipòsits
whine	grinyols
viewable	visible
loathsome	desconcertant
predatory	depredador
incorrect	incorrecte
besiege	assetja
plusses	aversions
sickeningly	malaltemente
pricey	car
devoid	desproveïda
insolently	insolent
congestion	congestió
uproarously	desesperadament
advantage	avantatge
clunky	entremaliat
aggrieved	agraviat
lawlessness	angoixa
primitive	primitiu
likable	estimable
effectiveness	efectivitat
pretence	pretensió
tentative	temptatiu
procrastination	dilacion
fooled	enganyat
berserk	boig
perseverance	perseverança
captivate	cautivar
properly	correctament
comfy	còmode
quarrellously	pelegrós
outsider	estranger
accolades	elogis
vengeance	venjança
cancer	càncer
hideous	horrible
mudslinger	fang
heal	curar
anti-occupation	anti-ocupació
hopelessness	desesperança
fume	fum
incomprehensible	incomprensible
ashamed	avergonyit
shirk	fracassar
distort	distorsionar
fans	ventiladors
officious	oficioso
congratulations	felicitacions
grace	gràcia
cumbersome	engorrosa
unlamentable	inigualable
heck	diables
opposition	oposició
dispute	disputa
absurdly	absurdament
articulate	articular
frozen	congelat
vindictiveness	venjança
shriek	cridar
dungeons	masmorres
bluring	desdibuixat
fatuity	fatuïtat
discouragingly	descoratjadorament
contaminating	contaminant
underlings	subratllats
declaim	declam
dragging	arrossegant
set-up	configuració
degenerate	degenerar
drags	arrossega
foolhardy	enganyós
dishonor	deshonor
charitable	caritatiu
shamelessly	descaradament
subjugate	subjugar
nicest	millor
somber	sombre
resilient	resistent
restored	restaurada
offensiveness	ofensiva
dissatisfy	descontent
rightful	legítim
incapably	incapaçment
upgradable	actualitzable
subpoenas	citacions
throbbing	palpitant
intimate	Íntim
overbalanced	equilibrat
gaily	alegre
lovably	amablement
beautify	embellir
licentiousness	licenciositat
scandal	escàndol
sketchy	incompleta
exhilaratingly	emocionant
overdone	exagerat
lawful	legal
devil	diable
refusal	negativa
villainously	vilmente
enflame	inflar
tangles	enredos
dazzle	enlluernar
kindness	bondat
fallout	caure
stupified	estupidament
arrogantly	arrogantemente
fanaticism	fanatisme
feign	fingir
hateful	odiós
affability	afable
catastrophic	catastròfic
cooperative	cooperativa
entangle	enredar
obese	obesitat
caricature	caricatura
piety	pietat
rapt	aveteu
infested	infestat
offensively	ofensivament
burden	càrrega
sagacity	sagacitat
damaged	espatllat
unwarranted	injustificat
break-up	trencar
banish	desterrar
crumbling	esmicolant
fried	fregit
eviscerate	eviscerar
imbecile	imbécil
mists	boires
helpful	Útil
deft	bo
obsessively	obsessivament
adamantly	fermament
fault	falta
precipitous	precipitada
disappoint	decebre
strikingly	sorprenentment
unproductive	improductiu
demeaning	demeanant
scummy	escumós
exceled	excel·lent
striving	esforçant
entice	atreure
blackmail	xantatge
appreciate	apreciar
slaughter	matança
rusty	rovellat
devilishly	diabòlicament
impending	imminent
instigate	instigar
wane	perdre
neurotic	neuròtic
reproach	retret
powerless	impotent
shipwreck	naufragi
sucker	aixovador
diligently	diligentment
over-hyped	sobre-hyped
apprehension	aprensió
wrangle	disputa
infraction	infracció
enliven	animat
defy	desafiar
disapointment	decepció
outrage	indignació
naively	ingenu
haggle	regatejar
ingeniously	enginyosament
murderous	assassí
inopportune	inoportú
virtue	virtut
competitive	competitiu
smudged	mancat
exhilaration	alegria
frustratingly	frustrantment
fruitful	fructífer
grudge	rencor
unlimited	il·limitat
delinquency	delinqüència
decadence	decadència
bored	avorrit
overwhelming	aclaparadora
rapport	informe
sprightly	francament
fulfillment	realització
famed	famós
embroil	embriagar
condescending	condescendent
squabbling	lluitar
survivor	supervivent
insubstantial	insubstancial
ominous	ominós
accommodative	acollidor
cancerous	cancerós
grandeur	grandesa
villianously	vilànicament
sucks	xucla
irresponsible	irresponsable
ecstasy	Èxtasi
laid-off	acomiadat
bewilderingly	desconcertant
heroine	heroïna
escapade	escapada
positives	positius
extinguish	extingir
odd	estrany
inequitably	inequívocament
swindle	estafa
praising	lloant
haters	enemics
erroneously	erròniament
egocentric	egocèntric
skinny	flac
attack	atac
wrestle	lluitar
elation	elació
squirm	calmar
distressed	afligit
snappish	trencant
jaw-droping	mandibular
hysterically	histèricament
defects	defectes
inconsequently	inconsecuentemente
irresolvable	irresoluble
distinguished	distingit
thrill	emoció
paucity	escassetat
tainted	contaminat
radicalization	radicalització
dubious	dubtós
improperly	indegudament
martyrdom	martiri
misgiving	indulgent
mocking	burlant
graceful	agraciat
harden	endurir
lull	calma
tattered	esquinçat
acridly	acridament
heavenly	celestial
outshine	esclatar
diversified	diversificat
tarnished	embruixat
egotism	egotisme
impoverished	empobrit
hefty	abundant
sedentary	sedentari
miss	senyoreta
spooky	fantasmal
deserving	mereixedor
capable	capaç
smelling	olorant
assurances	assegurances
doubts	dubtes
disaster	desastre
hilarious	hilarant
prattle	practle
imprecise	imprecís
divine	diví
washed-out	rentat
excites	excita
precise	precís
indiscretion	indiscreció
dehumanization	deshumanització
immaculately	immaculadament
tragic	tràgic
incitement	incitació
jam	melmelada
tantrum	birra
verifiable	verificable
anarchism	anarquisme
abyss	abisme
indoctrinate	adoctrinate
outperforms	supera
subversively	subversivament
disabled	desactivat
guiltily	culpable
domineering	domini
hassles	molèsties
livid	líquid
hurted	dolgut
dissappointing	decepcionant
flaky	escamós
strenuous	vigorós
anomalous	anòmal
despot	dèspota
lame	coix
unsettle	inestable
suffer	pateix
famine	fam
loathing	aversió
excruciating	excruciant
eulogize	eulogiar
enthralled	fascinant
goodness	bondat
imprison	empresonar
adventurous	aventurer
disconcerted	desconcertat
leer	llegir
reformed	reformat
appreciable	apreciable
deceiver	enganyador
bitch	puta
comfortable	còmode
stolen	robat
gloom	tristesa
contrasty	contrastada
restructured	reestructurat
cunts	cats
recommended	recomanat
anti-semites	antisemites
posh	elegant
stupendously	estupendamente
belligerently	belligerament
languid	lànguid
paralyzed	paralitzat
agonizingly	agonitzant
haze	boirina
adulate	adul·lar
disapproving	rebutjant
self-interested	interessat
deny	negar
viper	escurçó
smudges	manchas
snag	atropellament
morbidly	morbidament
righten	dret
rupture	ruptura
testily	testament
cleanly	net
harried	atrapats
keenness	agudesa
infringe	infringir
paradise	paradís
false	fals
failures	fracassos
bleeding	sagnat
merit	mèrit
implausibly	implacablement
persecution	persecució
spew	saltar
winner	guanyador
displeasing	disgustant
admonisher	advertidor
striking	sorprenent
thriving	prosperant
overtake	avançar
errant	errante
grief	pena
substantive	substantiu
cheating	trampa
reaffirmation	reafirmació
secretive	secretiva
stingingly	picantament
sustainable	sostenible
sanctimonious	santificós
lethargic	letargs
awards	premis
felicity	felicitat
unnoticed	desapercebut
indecisive	indecís
vexing	molest
rude	groller
sob	sollozo
dauntingly	intimidant
bothered	molestat
injustices	injustícies
raped	violada
futilely	inútil
luckiness	sort
despondently	despreocupadament
sinister	sinistre
stubborn	obstinat
wreaked	embolicat
adverse	advers
dishonorable	deshonorable
dismissively	despreciable
dynamic	dinàmic
joker	bromista
torture	tortura
disinclination	desinformació
embroiled	embruixat
loath	repugnància
stigma	estigma
illuminating	il·luminant
momentous	momentós
kindly	amablement
upheaval	trastorn
rife	abundant
dissatisfactory	insatisfactori
ruinous	ruïnós
enchant	encantar
rejoicing	alegria
harmoniously	harmoniosament
master	mestre
lonesome	solitari
expensive	car
flairs	socis
affordable	assequible
musty	mossegant
nonexistent	inexistent
deceivers	enganyadors
blow	cop
confrontational	confrontació
advocated	defensat
lucrative	lucratiu
affluent	afluent
novelty	novetat
tramp	vagabund
deceptive	enganyós
dreary	trist
improve	millorar
monumentally	monumentalment
suspicious	sospitós
relapse	recaiguda
mendacious	mendaz
bruises	contusions
gainsay	guanyar
skeletons	esquelets
over-awe	sorprenent
unassailable	inassequible
tingled	barrejat
afford	pagar
remorsefully	remordidament
inaccurate	inexacte
overblown	exagerat
unkind	desconsiderat
awful	horrible
recover	recuperar
tanked	tancat
tormented	atormentat
disclaim	renunciar
hegemonism	hegemonisme
payback	retrocés
raping	violació
unfairly	injustament
persevere	perseverar
outcry	crit
unequal	desigual
struggles	lluites
barbarous	bàrbar
self-serving	autoservei
broken	trencat
overplay	exagerat
fortuitous	fortuït
stormy	tempestuós
mystery	misteri
wary	desconegut
fall	caure
honored	honrat
sufferer	malalt
limitations	limitacions
disprove	refutar
obscene	obscè
punitive	punitiu
boost	estímul
stuffy	congestionada
sarcasm	sarcasme
inadverent	inadvertit
leakage	fuites
itchy	picor
insufficiency	insuficiència
loathly	dubtós
phony	fals
spendy	gastat
mightily	poderosament
affectation	afectació
prosecute	perseguir
drained	esgotat
legendary	llegendari
mist	boira
hindrance	impediment
picket	piquet
undermines	soscava
screech	calfar
burdensome	incrèdul
bomb	bomba
unwieldy	incòmode
impair	perjudicar
disoriented	desorientat
unsupportive	incondicional
nauseates	nàusees
incite	incitar
nasty	desagradable
savage	salvatge
disinterest	desinterès
unrelenting	incansable
promptly	immediatament
egregiously	exageradament
crumple	esmicolar
continuity	continuïtat
hostage	ostatge
invasive	invasiu
gimmicky	genial
jaundiced	icteriat
demolish	demolir
flexibility	flexibilitat
corrupts	corrupte
clean	net
scars	cicatrius
sinisterly	sinistre
lying	estirat
crude	cru
assassinate	assassinar
notoriously	notoriamente
advocate	advocar
stifling	sofocant
mad	boig
wonderful	meravellós
spilling	vessant
hysterics	histèria
sorrowfully	tristement
amazing	sorprenent
injurious	injuriosa
straggler	estraggler
freedom	llibertat
prickles	picades
blindingly	cegament
inability	incapacitat
inept	inepto
delusion	engany
graft	empelt
cataclysm	cataclisme
righteous	just
prolific	prolífic
debasement	degradació
debt	deute
deviousness	desviament
ploy	trampa
jerk	estrèpit
layoff-happy	acomiadat-feliç
prison	presó
indulge	complaure
unjustifiably	injustificadament
stagnant	estancat
austere	auster
demonizing	demonizando
contradictory	contradictori
ridiculously	ridículament
mesmerizes	hipnotitza
solicitude	sol·licitud
disappointing	decebedor
audibly	audible
autonomous	autònom
refinement	refinament
latency	latència
rejected	rebutjada
preferable	preferible
criticisms	crítiques
gems	gemmes
poverty	pobresa
dope	droga
adjustable	ajustable
intriguingly	intrigant
damnation	condemnació
sacrificed	sacrificat
colorful	colorit
rapid	ràpid
disappointingly	decebedor
uninformed	desinformat
rail	ferrocarril
adversity	adversitat
topple	abaixar
comprehensive	complet
baffle	deflector
economical	econòmic
maliciously	maliciosament
quarrelsome	disputada
radiance	resplendor
refunded	reemborsat
petty	petit
matchless	inigualable
fluent	fluid
downturns	desacceleració
wild	salvatge
smuttier	smutter
incomplete	incomplet
delicious	deliciós
chaff	palla
stately	senyorial
ameliorate	millorar
stagnate	estancar
heretical	heretica
excitingly	emocionant
glowing	brillantor
affably	afablement
shiny	brillant
disgustedly	desagradable
apprehensions	aprensions
victory	victòria
dwindling	disminució
anti-american	antiamericà
retractable	retràctil
timidly	timidament
undue	indegudament
contaminates	contamina
fuzzy	borrós
virulently	virulentament
ruined	arruïnat
admirer	admirador
perfectly	perfectament
resentful	ressentit
scowl	enfosquiment
grand	gran
nicer	millor
ultimatums	ultimàtum
dodgey	esquivo
mediocrity	mediocritat
oppositions	oposicions
humble	humil
taunting	inquietant
superb	excel·lent
neglect	negligència
soothingly	tranquil·lament
strike	colpejar
cherished	estimat
refine	refinar
brashly	francament
ingenious	enginyós
barbarously	bàrbarament
inspire	inspirar
exclusion	exclusió
grim	tèrmic
undefined	indefinit
bait	esquer
superstition	superstició
charismatic	carismàtic
luck	sort
upsets	molestos
superfluous	superflu
ovation	ovació
inconsistencies	inconsistències
affluence	riquesa
laudable	lloable
enemies	enemics
touchy	tàctil
extremist	extremista
gratefully	agraït
invaluable	inestimable
reasoned	raonat
warm	càlid
delightfully	deliciosament
tired	cansat
profuse	profus
hardened	endurit
enemy	enemic
chatter	xat
attune	ajut
weariness	cansament
warned	advertit
incompetence	incompetència
sensibly	sensiblement
sucked	xuclat
reachable	accessible
racist	racista
threats	amenaces
breakdown	desglossament
squeals	xafarderies
injury	ferida
abrupt	abrupte
buoyant	boia
brutalising	brutalitzant
torturously	tortuosament
gainsayer	guanyador
complimentary	gratuït
numb	entumit
treasonous	traidor
commotion	commoció
vile	vil
treacherously	traïdora
far-fetched	llunyà
orderly	ordenat
despoil	esborrar
compulsive	compulsiu
eases	facilita
loopholes	llacunes
finagle	finaguera
unusual	inusual
unlawfully	il·legalment
genuine	genuí
hinder	obstaculitza
wrinkles	arrugues
uproarious	molest
stirringly	agitadament
jerky	cruixent
ungovernable	ingovernable
imperfect	imperfecte
tediously	tediosamente
judicious	prudent
agility	agilitat
intense	intens
brainy	intel·ligent
weirdly	estranyament
wack	falla
fist	puny
atrocious	atroç
originality	originalitat
tumultuous	tumultuós
gain	guany
frail	fràgil
examplary	examen
inadvisably	desaconsellablement
kudos	felicitats
detests	detesta
dishonestly	deshonest
vivacious	vivaz
woeful	lamentable
titillating	titilar
masterfully	magistralment
vileness	vilesa
brimstone	sofre
bland	soso
scuff	trampa
palatial	palaciego
idle	ociós
joyful	alegre
knowledgeable	coneixedor
bashful	boig
modesty	modèstia
adequate	adequat
apologists	apologistes
chill	escalfa
suicide	suïcidi
wickedly	malament
disvalue	desvaloritzar
trusting	confiant
drunken	borratxo
unsteady	inestable
genocide	genocidi
disaffect	disgust
sumptuousness	sumptuositat
courteous	cortès
arcane	arcà
flaw	defecte
abused	abusat
monstrosity	monstruositat
perish	morir
stridently	estridentment
uproot	desarrelament
credible	creïble
cheery	alegre
simplifies	simplifica
horrifying	horrorós
humorously	humorísticament
luxuriant	exuberant
commendably	encomiable
strut	puntal
foolishly	francament
revengefully	revenja
undignified	indignat
dissatisfied	insatisfet
nice	agradable
shambles	rugeix
carelessness	descuit
disastrously	desastrós
disturbed	pertorbat
lyrical	líric
fraught	ple
franticly	frenèticament
fulminate	fulminar
gruesome	horrible
displeasure	descontentament
misrepresent	tergiversar
healthful	saludable
dishearteningly	descoratjador
pre-eminent	preeminent
drought	sequera
genius	geni
atrophy	atròfia
lament	lamentar
dignity	dignitat
win	guanyar
evasive	evasiu
accomplishment	realització
obstructing	obstruir
moan	gemegar
quarrellous	baralla
stupendous	estupend
fears	temors
uncertain	incert
disgrace	desgràcia
amusingly	divertitament
unspeakablely	inequívocament
divinely	divinament
itch	picor
irrecoverable	irrecuperable
disagreeably	desagradable
recommend	recomano
downhill	baixada
quarrels	baralles
lechery	lleteria
tidy	ordenat
smoldering	ardorós
benefit	benefici
irritating	irritant
foully	malament
delinquent	delinqüent
irrationally	irracionalment
improper	inadequat
enthusiast	entusiasta
encourage	animar
sour	Àcid
everlasting	etern
bloodthirsty	sanguinari
annihilate	aniquilar
butchery	carnisseria
nightmarish	sorpresa
brutally	brutalment
oversight	supervisió
deception	engany
languorous	languidora
annoyed	molest
boil	bullir
dishearten	descansar
cave	cova
rejuvenating	rejovenint
pervasive	penetrant
outstanding	excepcional
smoothes	suavitza
preposterous	absurd
betrayal	traïció
lags	retards
liberate	alliberar
disorganized	desorganitzat
deadlock	estancament
grotesque	grotesc
remission	remissió
lemon	llimona
repulsing	rebutjant
lucid	lúcid
inappropriate	inadequat
insincerity	insinceritat
confound	confondre
illuminate	il·luminar
zealous	zelós
partisan	partidista
slaughtered	sacrificat
proving	provant
patriotic	patriòtic
remorseful	remordedor
bores	forats
pathetic	patètic
smouldering	ardorós
flirty	coqueta
antiquated	antiquat
unimaginably	inimaginablement
delay	retard
lugubrious	lúgubre
addicting	addictiu
deviously	evidentment
irrepressible	irreprimible
mesmerized	hipnotitzat
laudably	laudablement
subordinate	subordinat
entrapment	atrapament
promised	promet
tickle	pessigolles
danken	falla
disturbance	pertorbació
disconcertingly	desconcertant
mistified	mistificat
allegations	al·legacions
eloquent	eloqüent
awkwardness	incomoditat
prodigiously	prodigiosament
outperformed	millorat
flatteringly	afortunadament
astonishing	sorprenent
daringly	atreviment
soothe	calmar
wonder	meravella
affirmation	afirmació
flighty	poderosos
surreal	surrealista
ghastly	horrible
advantages	avantatges
unpleasantries	desagradables
obliterated	esborrat
steady	constant
cheated	enganyat
agonize	agonitzar
vibrating	vibrant
trouble	problemes
graciousness	gràcia
creepy	horripilant
resound	ressonen
ironically	irònicament
derogatory	derogatori
approve	aprovar
nettlesome	indulgent
inarticulate	inarticular
maturity	maduresa
finely	finament
acclaim	aclamació
misleading	enganyós
angriness	angoixa
butcher	carnisser
peeled	pelat
static	estàtic
incongruously	incongruentment
misinformed	desinformat
deplorably	deplorable
protect	protegir
restful	tranquil
anguish	angoixa
gaining	guanyant
exhaust	escapament
nightmarishly	amablement
enthusiasm	entusiasme
enhanced	millorat
grouchy	groc
desperate	desesperat
hostile	hostil
deceiving	enganyant
virtuous	virtuós
thrifty	estalviador
magnificence	magnificència
rejection	rebuig
affliction	aflicció
unforgiving	implacable
hate	odi
hail	calamarsa
suave	suau
idolized	idolatrat
laughingstock	riureda
uncivil	incivil
insufficiently	insuficient
spoilages	escomeses
perturbed	perturbat
marvels	meravelles
pathetically	patèticament
squabble	lluita
catchy	enganxós
traction	tracció
scandalized	escandalitzat
subsidizing	subvencionant
quaint	pintoresc
famished	fam
clear-cut	clar
lover	amant
damaging	danyant
cheerful	alegre
magnificent	magnífic
flatter	afalagar
solid	sòlid
valuable	valuós
tiringly	cansadament
hatefully	odiosament
haunt	perseguir
objection	objecció
servitude	servitud
hopeful	esperançador
unselfish	desinteressat
hostility	hostilitat
failed	fracassat
mercifully	mercè
rigidness	rigidesa
tenaciously	tenazmente
contrariness	contrarietat
silent	silenciós
exasperating	exasperant
pillory	picota
detract	detriment
excellency	excel·lència
harmful	perjudicial
goad	goig
fever	febre
nervousness	nerviosisme
erratic	erràtic
openness	obertura
fallen	caigut
calm	calma
prejudices	prejudicis
crushed	aixafat
twinkly	centellejant
satisfies	satisfà
plush	felpa
durable	durador
virtuously	pràcticament
sidetrack	desviament
fast	ràpid
desititute	desitjable
detestably	detestablement
tedious	tediós
distrusting	desconfiança
dumping	abocament
wonderously	meravellosament
erodes	erosiona
heartbreaker	trencaclosques
rigid	rígid
aggravate	agreujar
bereft	abandonat
staunch	ferm
obscenely	obscenament
miser	avaro
humorous	humorístic
frustrations	frustracions
fictitious	fictici
clique	cliqueu
timely	puntual
rough	rugós
ranting	desviació
luxury	luxe
uphold	defensar
disappoints	decepcions
generosity	generositat
flirt	coquetejar
undisputed	indiscutit
dejectedly	desagradable
peril	perill
fabricate	fabricar
ineloquently	inelucent
grumble	callar
refreshed	actualitzat
oppressive	opressiu
tyrannically	tirànnicament
monotony	monotonia
diabolic	diabòlic
strife	lluita
undercutting	baixada
swollen	inflat
balanced	equilibrat
chilly	fred
wicked	malvat
trick	truc
stampede	allau
dusty	polsós
wasting	perdent
irony	ironia
torturing	torturar
leery	alegre
oppress	opressió
flaunt	ostentar
undermine	minar
mess	desordre
smother	sofriment
racy	cruixent
superbly	excel·lentment
lamentably	lamentablement
cost-effective	rendible
misfit	incomplir
forsake	abandonar
easy	fàcil
felonious	feloniós
won	guanyat
distraughtness	distracció
gloomy	sombrío
irretating	irreting
tender	tendre
skimpy	escàs
disadvantage	desavantatge
vibrate	vibrar
stressful	estressant
aspire	aspirar
spoilage	malmetre
shame	vergonya
contentment	alegria
corrupting	corrompido
frolic	esgarrifós
faithfully	fidelment
progress	progrés
demoralizingly	desmoralitzant
amicability	amistat
jealousy	gelosia
anti-white	anti-blanc
unworkable	inabastable
violate	viola
dubitable	dubitativa
object	objecte
misunderstandings	malentesos
dissenter	dissensió
charm	encant
controversy	controvèrsia
insincere	insincera
underestimate	subestimar
tauntingly	inquietant
relief	alleujament
abolish	abolir
boring	avorrit
renown	fama
astound	sorprenent
cataclysmic	cataclísmic
sneeringly	descaradament
perplexed	perplex
surrender	rendició
reform	reforma
exorbitantly	exorbitant
aggravation	agreujament
unfortunate	desafortunat
anarchist	anarquista
appalling	horrorós
debase	refús
elated	ansiós
uneasy	incòmode
supporter	partidari
taut	tens
cramp	rampa
perilously	perillosament
fine	bé
remunerate	remunerar
empathize	empatia
spitefully	pertortadament
hassled	molestat
unequivocal	inequívoc
deprecate	obsolet
sues	demanda
rapture	rapto
fundamentalism	fonamentalisme
misaligned	desalineado
bristle	truges
extremists	extremistes
precisely	precisament
bully	intimidació
one-sided	unilateral
dirty	brut
spirited	esperit
praise	lloança
intolerablely	intolerable
spiteful	lamentable
smell	olor
feasible	factible
chore	feina
sustainability	sostenibilitat
uncomfy	incompatible
warning	advertència
curse	maledicció
lean	inclinació
enrich	enriquir
simplifying	simplificant
imperialist	imperialista
threesome	trío
malevolently	malévolamente
repugnance	repugnància
mortification	mortificació
layoff	despatx
agony	agonia
impedance	impedància
exalting	exaltació
conciliate	conciliar
unquestionable	indiscutible
beset	assetjat
feint	pretensió
lifesaver	salvavides
fervid	fervent
unconstitutional	inconstitucional
dismaying	disgustant
tentatively	provisionalment
instantly	instantàniament
togetherness	unió
regrettably	lamentablement
addicts	addictes
anxious	ansiós
inaccuracies	inexactituds
achievement	assoliment
resourceful	enginyós
refresh	actualització
devastate	devastar
dissatisfying	descontent
stupid	estúpid
unrivaled	inigualable
tricked	enganyat
strict	estricta
restless	inquiet
anti-proliferation	antiproliferació
bashed	banyat
perversity	perversitat
intoxicate	intoxicar
personalized	personalitzat
betrays	traeix
rumours	rumors
misrepresentation	tergiversació
fascinatingly	fascinant
maneuverable	maniobrable
freed	alliberat
brutalize	brutalitzar
crook	lladre
filthy	brut
heartbreaking	desgarrador
pickets	piquets
invalid	invàlid
knotted	nusos
awesomeness	increïble
disadvantages	desavantatges
flattering	halagador
hedonistic	hedonista
decisive	decisiu
irretrievable	irrecuperable
defeat	derrota
foresight	previsió
inundated	inundat
solicitous	sol.licit
splendor	esplendor
die-hard	morir-dur
enjoyment	gaudi
exuberance	exuberància
panick	pànic
sinfully	pecaminosament
wrip	empenta
imaginative	imaginatiu
debts	deutes
hated	odiat
paupers	pobres
embarrassing	embarazoso
commotions	commocio
wreck	naufragi
secure	segur
sin	pecat
ignorance	ignorància
buckle	sivella
fond	aficionat
critical	crític
indignation	indignació
spellbinding	fascinant
mundane	mundà
alienate	alienar
confront	confrontar
constructive	constructiu
fervidly	ferventament
pinnacle	pinacle
galling	enganyant
humiliate	humiliar
tragically	tràgicament
hot	calenta
gaiety	alegria
visionary	visionari
readable	llegible
intrusion	intrusió
carp	carpa
upgradeable	actualitzable
irregularity	irregularitat
pepping	picar
liars	mentiders
risks	riscos
culprit	culpable
crisis	crisi
liable	responsable
excelent	excel·lent
revolutionary	revolucionari
casualty	víctima
pugnacity	pugnacitat
plotters	traçadors
preferes	prefereix
pleasantly	agradablement
burns	cremades
tough	dur
skittishly	descoratjadorament
gleeful	alegre
presumptuously	presumptament
clueless	despistada
discouraging	descoratjant
optimistic	optimista
domineer	domini
dreadfulness	terrible
skeptical	escèptic
bumpping	picar
harmonious	harmoniós
calamity	calamitat
obstruct	obstruir
midget	Àvia
untrue	fals
indulgence	indulgència
volatility	volatilitat
miraculously	miraculosament
affront	afrontament
reassurance	tranquil·litat
disturbing	inquietant
lure	atraure
scum	escòria
spotty	irregular
forgetfully	oblidat
fascinate	fascina
aground	encallat
pernicious	perniciosa
downheartedly	descoratjador
uncomfortably	incòmodament
breaking	trencament
neat	net
bogus	fals
lost	perdut
ignominious	ignominiosa
uneasiness	inquietud
improved	millorat
unwise	imprudent
lumpy	boig
coherence	coherència
severity	gravetat
disgruntle	descontent
disruption	interrupció
gallingly	cruelment
abundance	abundància
rich	ric
complementary	complementari
exaggeration	exageració
turmoil	confusió
untruthful	fals
endorsement	aval
decay	decaïment
alienated	alienat
paranoid	paranoico
joyously	alegrement
fetid	fètida
trophy	trofeu
rut	rutina
conflicts	conflictes
defensive	defensiu
suspicions	sospites
dizzingly	enutjós
pamper	mimar
wrong	mal
enthusiastic	entusiasta
coldly	fredament
fictional	ficció
vanity	vanitat
decisiveness	decisivitat
noxious	nocius
beastly	bestial
shadowy	ombrívol
imminently	inminente
shiver	estremiment
obtainable	obtinguda
neglected	descuidat
iniquity	iniquitat
adulation	adulació
capitulate	capitular
anxiousness	ansietat
incense	encens
pitilessly	despiadadamente
fatal	mortal
maddeningly	enutjat
entertains	entreté
heartening	coratge
appalled	horroritzat
catastrophe	catàstrofe
subdued	submergit
despised	menyspreat
compassionate	compassiu
cruelly	cruelmente
suffered	patit
deadbeat	mortalitat
freedoms	llibertats
wrongful	injust
resent	ressentir
straining	esforçant-se
overzealous	excessiu
desultory	desolat
selfishly	egoista
immovable	immòbil
exceeding	superant
coupists	copistes
propitious	propici
cowardly	covard
crippled	paralitzat
lead	dirigir
wobble	bessona
toughness	duresa
congratulation	felicitació
excuse	excusa
grievance	queixa
sparkling	escumós
dread	temor
stress	estrès
downbeat	pitjor
tantalizing	tastant
jealously	gelosament
cloudy	ennuvolat
bulkiness	massatge
presumptuous	presumptuós
snarl	ronca
mature	madur
amicably	amigablement
wonderfully	meravellosament
eyesore	ulleres
non-violence	no-violència
needy	necessitats
bleeds	sagnen
rift	escletxa
dissuade	dissuadir
restructuring	reestructuració
malodorous	malolor
shrilly	esgarrifós
gimmicking	immersió
insightfully	intuïtivament
stumbles	ensopega
warlike	guerrer
impunity	impunitat
joke	broma
triumph	triomf
degeneration	degeneració
overtaxed	sobretaxat
outstrip	superar
atrocity	atrocitat
wilt	gemec
instigator	instigador
mock	burla
great	genial
astonish	sorprendre
riled	clavat
squeak	esclava
overwhelmingly	abrumadorament
showdown	enfrontament
provocation	provocació
farce	farsa
inconsequent	inconsecuentes
fallaciously	fallat
cleared	aclarit
outcast	marginat
hardheaded	capçal
defender	defensor
antagonism	antagonisme
donside	abandonat
failing	fallant
thankless	agraït
unaccustomed	desacostumat
exceptionally	excepcionalment
futile	fútil
downfallen	baixada
uneasily	inquietant
cheapen	barat
impractical	impracticable
poison	verí
gladness	alegria
pleasant	agradable
manipulators	manipuladors
shemale	transsexual
disrespectable	indescriptible
mashed	puré
deginified	deginificat
imminence	imminència
disillusionment	desil·lusió
helplessly	impotent
improvements	millores
sleazy	dolça
fracture	fractura
restructure	reestructurar
grateful	agraït
swelling	inflor
baffled	desconcertat
strident	estrident
wrest	arrencar
promise	promesa
fragile	fràgil
picketing	piquet
penalty	penalització
forsaken	abandonat
unwavering	incondicional
scratches	ratllades
disadvantageous	desavantatges
delicacy	delicadesa
tepid	tebi
pales	pal·les
vibration	vibració
self-destructive	autodestructiu
stupidly	estupidament
delaying	retard
lush	exuberant
carnage	carnisseria
preferring	preferint
outperforming	superant
raving	fastigós
sharply	bruscament
treasure	tresor
glisten	brillar
disrespectful	irrespetuós
tank	tanc
effusively	efectivament
nauseatingly	nàusees
dishonest	deshonest
hapless	infeliç
enviousness	enveja
dud	dub
precious	preciós
grieve	dolent
abounds	abundant
needless	innecessari
critic	crític
splitting	dividint
righteousness	justícia
unthinkable	impensable
restlessness	inquietud
raging	furiós
slumpping	baixant
killer	assassí
temerity	temeritat
repressive	repressiu
ordeal	calvície
deceitful	enganyós
perfidious	perfidioso
wretchedness	miserable
harmonize	harmonitzar
smoulder	smolder
daunt	dimonis
fecilitous	fecilit
witty	enginyós
comely	còmodament
foremost	sobretot
rhetorical	retòrica
excessively	excessivament
self-sufficiency	autosuficiència
indiscriminating	indiscriminada
disbeliever	incrèduls
stutter	tartamudeja
starvation	fam
exhausted	esgotat
disgust	disgustat
infallible	infalible
outburst	explosió
refutes	refuta
wretchedly	desgraciadament
deform	deformar
blaspheme	blasfemar
exuberantly	exuberant
failure	fracàs
negativity	negativitat
meltdown	fuga
cataclysmal	cataclisme
madly	boig
draining	drenatge
fail	falla
enchanted	encantat
ludicrous	ridícul
hates	odia
extermination	extermini
dumbfounding	absurd
advantageously	avantatjosament
marvel	meravella
bigotry	fanatisme
attraction	atracció
greedy	cobdiciós
heartbreakingly	desgarradorament
over-valuation	sobrevaloració
spotless	impecable
delusional	delirant
infection	infecció
unemployed	aturat
privileged	privilegiada
ambivalence	ambivalència
gratifies	gratifica
undermining	soscavant
symptoms	símptomes
ecstasies	Èxtasis
conspirator	conspirador
conflict	conflicte
invincible	invencible
allergic	al·lèrgic
emphatic	enfàtic
covetous	avorrit
pig	porc
epidemic	epidèmia
greed	avidesa
speedy	ràpid
fleer	fang
lackluster	absurd
assuring	assegurant
discontinuous	discontinu
felicitous	felicitat
rapturous	estúpids
expunge	expulsar
awesome	increïble
banalize	banalizar
cheer	alegria
capability	capacitat
ebulliently	exageradament
addicted	addicta
disarray	desordre
isolate	aïllar
prosperous	pròsper
glamorous	glamurós
concession	concessió
mistress	amant
drunk	borratxo
elegance	elegància
talented	talentós
freak	monstre
savagery	salvatgisme
impartially	imparcial
detracting	disminuir
hangs	penja
ax	destral
vociferous	vociferant
ugly	fea
traped	enganxat
humming	tararejant
gladden	alegre
hysterical	histèric
lurch	empeny
perversion	perversió
blind	cec
slut	puta
creaking	cruixit
effusion	efusión
inexpiable	inexpugnable
shortcoming	deficiència
defeated	derrotat
comfortably	còmodament
incongruous	incongruent
spurious	espurio
unsecure	insegura
acclamation	aclamació
exceeds	excedeix
handy	pràctic
avalanche	allau
enslave	esclau
extraneous	estrany
wholesome	saludable
belligerence	beligerància
foulness	faltes
bruised	ferit
exile	exili
get-rich	enriquir-se
conspire	conspié
embarrassingly	vergonyós
regretful	lamentable
squeaks	crits
posturing	postura
bloody	sagnant
reckless	imprudent
aspersion	aspersió
uncollectible	incobrable
revenge	venjança
homage	homenatge
relish	gaudeix
outmoded	obsolets
nightmare	malson
treachery	traïció
gratification	gratificació
thrillingly	emocionant
jeeringly	enginyós
assassin	assassí
mesmerizing	fascinant
savaged	salvat
overweight	sobrepès
plight	malament
unlawful	il·legal
frenzied	frenètic
incompetently	incompetentment
debilitating	debilitat
weary	cansat
abrasive	abrasiu
biased	tendenciat
tingling	formigueig
agreeableness	acceptable
useful	Útil
strain	tensió
screwed-up	fotut
languor	languidesa
destroy	destruir
excitedly	emocionats
mockingly	burlón
drowning	ofegament
regrettable	lamentable
hustler	empujador
gusto	gust
discombobulate	descombobular
unintelligile	incomprensible
allergies	al·lèrgies
industrious	treballador
spookily	espantós
scrambling	lluitar
grisly	grisamente
temper	temperament
insignificantly	insignificantment
sag	caure
douchebag	gilipolles
incredible	increïble
enmity	enemistat
nauseating	nàusees
allege	al·leguen
irritate	irritar
works	funciona
warmth	calidesa
darken	fosc
catastrophes	catàstrofes
vagueness	vaguedat
stubbornness	obstinació
unhelpful	inútil
sermonize	sermonitzar
warmhearted	afable
distraughtly	distraient
twists	girs
sophisticated	sofisticat
unsteadiness	inestabilitat
cynicism	cinisme
bad	dolent
vibrated	vibrat
crappy	boig
overkill	excessiva
parasite	paràsit
improbability	improbabilitat
loyalty	lleialtat
unuseably	inutilitzable
ruthlessness	crueltat
rewardingly	gratificant
leaks	fuites
flounder	llistó
passionate	apassionat
cons	contres
aversion	aversió
threatening	amenaçant
dissention	dissensió
gold	or
disrepute	descrèdia
insensitive	insensible
jagged	dentat
entertain	entretenir
prowess	proesa
lurk	escampa
revival	revitalització
unclean	impur
discoutinous	discutiu
brashness	fastositat
rational	racional
complaint	queixa
honest	honesta
protective	protector
radically	radicalment
oasis	oasi
malaise	malestar
unforgettable	inoblidable
swiftness	rapidesa
lecherous	lleig
sloth	mandros
imposition	imposició
contradiction	contradicció
variety	varietat
idol	Ídol
redeem	redimir
shimmeringly	brillantment
die	morir
reasonable	raonable
protests	protestes
pessimistic	pessimista
anomaly	anomalia
vexation	vexació
meddlesome	confús
luminous	lluminós
elegantly	elegantment
marvelousness	meravellosa
useless	inútil
inexorably	inexorablement
harms	danys
slogging	entreteniment
dead-cheap	mort-barat
fright	espanto
worthlessness	inutilitat
venom	verí
cheerless	alegre
infirm	malalt
perilous	perillós
egotistical	egoista
ingenuous	ingenu
immature	immadur
peculiarly	curiosament
traitorous	traïdor
effectual	efectual
headway	avanç
malicious	maliciós
chronic	crònica
senile	senil
stresses	accentua
ignore	ignorar
interference	interferència
trustworthiness	confiança
cunt	boira
disaccord	desacord
aching	dolor
dotingly	elegantment
worked	treballat
disillusion	desilusió
dreadfully	terriblement
droop	caiguda
threaten	amenaça
wasted	desperdiciat
enthral	fascinant
disapprobation	desaprovació
enterprising	emprendedor
displease	disgusta
incredulously	incrèdulament
discord	discòrdia
inhuman	inhumans
incapable	incapaç
amiability	amabilitat
prideful	orgullós
distraction	distracció
indignant	indignat
mischief	travesura
luster	brillantor
intolerance	intolerància
sap	saba
aggressiveness	agressivitat
apologist	apologista
affectionate	afectuós
idiotically	idiota
effusive	efusiu
disconsolate	desconsolar
sumptuous	sumptuós
rubbish	escombraries
frantic	frenètic
vigilance	vigilància
understandable	comprensible
troubles	problemes
disregardful	desconsiderat
troublingly	inquietant
contamination	contaminació
contaminate	contaminar
long-winded	llargues
idyllic	idíl.lic
sty	estil
exultation	exultació
salute	saludem
educated	educat
dissemble	dissimular
ingenuity	enginy
breaks	trencaments
excellant	excel·lent
fairness	justícia
addict	addicta
streamlined	racionalitzat
conspiracies	conspiracions
crisp	cruixent
seedy	cutre
unorthodoxy	ortodòxia
dunce	duna
meticulously	meticulosament
disappointed	decebut
scar	cicatriu
unrest	disturbis
bravery	valentia
glitter	purpurina
killing	matant
frigging	freda
levity	lleugeresa
noise	soroll
innuendo	innocent
anarchy	anarquia
guilt	culpa
idolize	idolatrar
interferes	interfereix
suspicion	sospita
derision	burla
triumphal	triomfal
inextricably	inextricablement
deplete	esgotar
excited	emocionat
cleverly	intel·ligentment
dilemma	dilema
suffering	patiment
leakages	fuites
fatigued	fatigat
affirmative	afirmatiu
subjected	sotmès
audiciously	auditivament
proven	provat
plea	súplica
supports	suports
pauper	captaire
aspirations	aspiracions
unacceptablely	inacceptablely
fanfare	fanfàrria
grieving	dolent
clear	clar
frenzy	frenesí
sickening	malestar
reviled	rebel·lat
infuriatingly	indignant
fanciful	fantasia
blinding	cegamiento
grate	reixeta
unmoved	immòbil
horrendously	horriblement
discourteous	discurs
bondage	esclavitud
adulterated	adulterat
godlike	déu
nurturing	cuidant
maniacal	maníacs
trusty	confiat
breathtakingly	sorprenentment
sceptical	escèptic
flaws	defectes
exaltedly	exaltada
battering	batre
celebrate	celebrar
stressfully	estressant
malevolence	malvolença
resignation	renúncia
encouraging	encoratjador
disgracefully	desgraciadament
quiet	tranquil
regretfully	lamentablement
dazzled	enlluernat
uproariously	desordenadament
depressing	depriment
defame	defamació
civility	civilitat
sincerity	sinceritat
silly	tonto
invective	invectiva
snappy	Àgil
malady	malaltia
prosperity	prosperitat
attacks	atacs
issue	assumpte
blur	borrós
undecided	indecisos
jeopardize	compromès
scrambles	baralles
disobedience	desobediència
blurring	borrós
amusing	divertit
foolproof	infalible
peach	préssec
refined	refinat
wheedle	xinxeta
ache	dolor
rewarding	gratificant
deviation	desviació
irrecoverably	irrecuperablement
impinge	impactar
sullen	estremit
insulted	insultat
indifference	indiferència
precarious	precari
led	dirigit
perfection	perfecció
incomparably	incomparablement
crooked	tortuós
smelt	olor
fret	estret
unyielding	inflexible
frets	trasts
uncouth	inconscient
hatefulness	odio
stellarly	estel·lar
pamperedly	mimat
restrictive	restrictiu
horrific	horrible
tyranny	tirania
whimper	gemecs
scam	estafa
coercion	coerció
purify	purificar
disquiet	inquietud
disfavor	disgust
statuesque	estatueta
appreciates	s'aprecia
erroneous	errònia
smutty	boig
dazzling	deslumbrante
succumb	sucumbir
debauchery	desertatge
wrongly	erròniament
revive	reviure
champ	campió
free	gratuït
well	bé
stigmatize	estigmatitzar
tiresome	cansat
bargain	ganga
racists	racistes
malice	malícia
biases	biaixos
thug	brètol
defiance	desafiament
belated	tardà
unknown	desconegut
savings	estalvis
overdue	endarrerit
revoltingly	revoltant
cute	bonic
magnificently	magníficament
available	disponible
unpredictable	imprevisible
achievible	assolible
cheater	tramposo
discontent	descontentament
darkness	foscor
unfamiliar	desconegut
dilly-dally	tranquil·lament
inequality	desigualtat
audacity	audàcia
disagreement	desacord
victimize	victimitzar
repulsive	repulsiu
gallantly	galantly
perverted	pervertit
beautiful	bonic
prestigious	prestigiós
misalign	desalinear
redundancy	redundància
oppressors	opressors
desecrate	profanar
anger	ràbia
good	bo
averse	aversió
gorgeous	preciosa
celebrated	celebrat
inefficiency	ineficiència
stimulating	estimulant
bewildered	desconcertat
savages	salvatges
vivid	vívid
ignominiously	ignominiosament
dirt	brutícia
frustrates	frustra
adamant	ferm
dignify	dignificar
cocky	engreixat
intriguing	intrigant
inexcusably	inexcusablement
extravagantly	extravagantment
smear	tacar
rage	ràbia
dented	dentat
fame	fama
scoffingly	ridículament
unpleasant	desagradable
scold	escolta
distorted	distorsionat
civilize	civilitzar
negligence	negligència
ironic	irònic
devilish	diabòlic
incompliant	incompleta
fast-paced	ràpidament
clarity	claredat
unsure	insegura
paradoxically	paradoxalment
insupportably	insuportablement
assure	assegureu-vos
tumble	caure
horrified	horroritzat
skillful	hàbil
fainthearted	descoratjat
fury	fúria
promoter	promotor
satisfactory	satisfactori
clamorous	clamorós
imaculate	imacular
polarisation	polarització
erode	erosionar
outraged	indignat
filth	brutícia
weak	feble
guidance	guia
ached	dolgut
picturesque	pintoresc
expertly	expertment
wise	prudent
repulsiveness	repulsivitat
reprehension	reprensió
irreplacible	irreplasible
enlightenment	il·luminació
daring	atrevit
yawn	badallar
inaccuracy	inexactitud
effrontery	infart
devilment	diable
pinch	pessigar
risk	risc
ineffectual	ineficaç
death	mort
menace	amenaça
stew	guisat
avarice	avarícia
disingenuous	desconcertant
replaceable	reemplaçable
scrap	ferralla
sneering	esmaltant
detesting	detestant
pugnaciously	contundentment
defamatory	difamatori
swelled	inflat
hearten	corazonado
imperfection	imperfecció
defiler	desertor
aches	dolors
irreplaceable	irreemplaçable
stymied	estancat
willingness	voluntat
decrement	disminució
craze	mania
comical	còmic
supple	flexible
tortuous	tortuós
prominence	protagonisme
adoring	adorant
exagerate	exagerat
deaf	sord
confuse	confondre
overbearingly	sobriament
mocks	esmaga
unhappily	infeliç
efficient	eficient
innovation	innovació
admonishingly	admoncientment
problems	problemes
aggrieve	agraviar
crush	aixafar
degradation	degradació
patriot	patriota
forbid	prohibir
inordinate	exagerat
dead	mort
denunciation	denúncia
unsettlingly	inquietant
hurt	ferit
strangle	estrangular
spoils	botí
ample	Àmplia
exaltation	exaltació
denigrate	denigrar
skilled	expert
worsen	empitjorar
wimpy	boig
phobia	fòbia
fatalistic	fatalista
paltry	molest
supported	recolzat
purposeful	intencionat
trivialize	trivialitzar
appeal	apel·lació
tease	burlar
rocky	rocós
provocative	provocatiu
militancy	militància
coerce	coaccionar
deterrent	dissuasiu
self-coup	autocupo
clog	obstruir
enjoyed	gaudit
stall	parada
uncreative	incrèdul
beggar	captaire
misaligns	desalineaments
throb	boig
sagging	flacciditat
annoyingly	molest
proper	propi
peace	pau
foul	falta
cherish	estimar
immaculate	immaculada
slanderously	calumniant
declining	disminuint
pity	llàstima
nourish	nodrir
apathetically	apàticament
beseech	preguem
comfort	confort
unbeatable	immillorable
draconian	draconiano
fabulous	fabulós
exceptional	excepcional
ridiculous	ridícul
unneeded	innecessari
merry	alegre
portable	portàtil
negation	negació
intimidation	intimidació
coward	covard
incorrigibly	incorrigible
unwatchable	inviable
irreproachable	irreprotxable
desiring	desitjant
awarded	guardonat
unfaithful	infidel
dismissive	despreocupat
splatter	salpicaduras
redeeming	bescanvi
capriciousness	capritxós
unbiased	imparcial
snare	trampa
excite	excitar
flare	flamarada
brave	valent
deprive	privar
despairing	desesperació
impressiveness	impressivitat
obstinate	obstinat
nobly	noble
fatty	greix
fragrant	fragant
earnestness	serietat
noteworthy	destacat
dishonorablely	deshonorablely
disobedient	desobedient
accusations	acusacions
lone	solitari
disobey	desobeir
glee	alegria
mesmerize	hipnotitzar
complaining	queixant-se
thrilled	emocionat
sluts	puta
forlorn	allunyat
ruffian	rufià
gratifying	gratificant
syndrome	síndrome
nifty	increïble
shake	sacsejar
extoll	exaltar
loveliness	bellesa
illustrious	il·lustre
deplore	deplorar
counter-attacks	contraatacs
frighteningly	espantós
incognizant	inconscient
earnest	seriós
vibrantly	vibrantment
embarrassment	vergonya
isolation	aïllament
awkward	incòmode
unravel	desembolicar
versatile	versàtil
pamperedness	mims
divisive	divisiva
sufficiently	prou
overtaking	avançament
boredom	avorriment
thrilling	emocionant
discomfititure	descomfitfit
inspiration	inspiració
flimsy	feble
bereave	genial
lagging	retardat
enjoin	pregunteu
spade	pala
disgustingly	desagradable
savior	salvador
dominate	dominar
improbably	improbablement
masterful	magistral
patient	pacient
impressive	impressionant
hard	dur
punish	castigar
marvelous	meravellós
untenable	insostenible
soft	suau
distastefully	desagradable
lustrous	brillant
hogs	porcs
flares	bengales
deceit	engany
accusing	acusant
brighten	alegre
unnerving	indignant
splendid	esplèndida
disapproval	desaprovació
symptom	símptoma
retardedness	retard
calumnies	calúmnies
dripped	gotejat
repudiate	repudiar
fleeing	fugint
ailing	malalta
temptingly	temptant
hung	penjat
swift	ràpid
relentless	implacable
happy	feliç
reprehensible	reprensible
maturely	madur
apprehensively	aprensivament
flees	fuig
onerously	inertemente
risky	arriscat
propagandize	propaganda
notoriety	notorietat
mastery	domini
inflationary	inflacionista
gimmicked	immobilitzat
abort	avortar
dungeon	masmorra
passiveness	passivitat
forgetful	oblidat
vengeful	venjoso
exhilarating	estimulant
misery	misèria
ecenomical	ecènic
resounding	ressonant
hiliarious	alegre
coercive	coercitiu
malign	maligne
indecency	indecencia
undisputable	indiscutible
desolation	desolació
orphan	orfe
obnoxious	desagradable
callous	callós
split	dividir
deficiency	deficiència
disoobedient	desobedient
contrived	ideat
forceful	contundent
err	errar
drop-outs	abandonaments
needlessly	innecessàriament
productive	productiu
cramped	estret
infamous	infame
kills	mata
energize	energitzar
regrets	lamenta
scandalous	escandalós
humid	humit
dangerous	perillós
individualized	individualitzat
accurate	precís
conflicting	conflictiu
ineloquent	ineloqüent
tenacious	tenaç
impugn	impugnar
dragged	arrossegat
sensationalize	sensacionalitzar
outrageously	escandalosament
reactionary	reaccionari
slave	esclau
blotchy	taca
sensitive	sensible
puzzling	desconcertant
prize	premi
compassion	compassió
hideousness	horrible
protesting	protestant
costly	costós
impatiently	impacient
autocrat	autòcrata
impassioned	apassionat
insulting	insultant
hastily	precipitadament
unquestionably	indubtablement
infiltrators	infiltrats
dick	polla
inflammatory	inflamatori
bullish	alcista
onerous	onerós
irresponsibly	irresponsablement
illness	malaltia
slowwww	disminuir
precipitate	precipitar
zealot	zelot
worryingly	preocupant
worries	preocupacions
wreak	provoca
inequalities	desigualtats
sensationally	sensacionalment
handsomely	genial
tempest	tempesta
reject	rebutjar
pest	plaga
exasperatingly	exasperant
bitchy	genial
delightfulness	delícia
tragedy	tragèdia
agonizing	agonitzant
heinous	horrible
worthiness	vàlua
apocalypse	apocalipsi
quarrel	baralla
commitment	compromís
defrauding	defraudant
degradingly	degradant
trashed	escombraries
selfishness	egoisme
rectify	rectificar
deploringly	deplorant
joyfully	alegrement
punctual	puntual
imbalance	desequilibri
nosey	boig
tenacity	tenacitat
abruptly	bruscament
excels	sobresurt
top	superior
stimulative	estimulant
mistrust	desconfiança
supremacy	supremacia
gains	guanys
amazes	sorprèn
issues	problemes
struggle	lluita
prefers	prefereix
hysteria	histeria
benefits	beneficis
misfortune	desgràcia
glimmering	brillant
pale	pàl·lid
pan	pa
accomplished	realitzat
fantastic	fantàstic
crashing	estavellant
madman	boig
dissolute	dissolt
disgruntled	descontent
rosy	rosat
lethargy	letargia
unreasonable	irracional
abominate	abominar
jumpy	saltós
elite	elit
usurper	usurpador
innocuous	innocu
carefree	despreocupat
preferably	preferiblement
treacherous	traïdor
flee	fugir
imprecate	imprec
stink	pudor
empathy	empatia
dragoon	drac
prodigious	prodigiós
skeptic	escèptic
affinity	afinitat
undesirable	indesitjable
fallaciousness	fallida
flareup	esclatar
sneaky	furtiu
victorious	victoriós
exquisitely	exquisitament
insanely	insanamente
bruising	moretones
yay	visca
blame	culpa
refreshing	refrescant
sturdy	resistent
abysmal	abismal
applaud	aplaudir
sober	sobri
poisonously	enverinant
effective	eficaç
traumatized	traumatizado
reprove	reproveix
uproar	esclat
murderer	assassí
bump	bony
kill	matar
mistrustful	desconfiat
gorgeously	magníficament
inefficient	ineficient
unacceptably	inacceptable
violators	infractors
aggravating	agreujant
inspirational	inspirador
disarm	desarmar
priceless	inestimable
troubling	inquietant
uneven	desigual
vibrates	vibra
willing	disposat
bonkers	bufadors
obscured	enfosquit
ugliness	lletjor
wrinkled	arrugat
deject	expulsar
discontented	descontent
painfull	dolorós
lagged	retardat
lethal	letal
providence	providència
craziness	bogeria
stimulate	estimular
angry	enutjat
commodious	commodiós
unprofitable	inútil
transgression	transgressió
eagerness	afany
devastatingly	devastadorament
bitter	amarg
valiant	valent
harpy	harpia
perfect	perfecte
intransigence	intransigència
destabilisation	desestabilització
weep	plorar
discourage	descoratjar
painful	dolorós
hoard	acumular
grin	sonrisa
corrupt	corrupte
enjoy	gaudir
success	Èxit
weaknesses	debilitats
disputed	disputat
superficiality	superficialitat
forbidden	prohibit
hurtful	perjudicial
asinininity	asininitat
flourishing	floreciente
unfulfilled	incomplert
agreeably	agradablement
inescapably	ineludiblement
barren	estèril
fallacies	fal·làcies
inefficiently	ineficientment
brutalities	brutalitats
cool	guai
doubt	dubte
unsuspecting	despreocupat
stench	pudent
worse	pitjor
tangled	enredat
revolutionized	revolucionat
flakey	escamós
excitement	emoció
trickery	trucs
interruption	interrupció
miserably	miserablement
leaky	fugaç
morality	moralitat
impetuous	impetuós
bless	beneeixi
swanky	espantós
assurance	garantia
pertinacious	pertinent
nagging	irritable
shunned	rebutjat
slur	boig
cringes	enganya
rifts	fractures
detracted	detret
peacekeepers	pacificadors
fastidious	fastidiós
shamefulness	vergonya
simplify	simplificar
intimidatingly	intimidant
goading	endurint
overstatement	exageració
benifits	beneficis
celebration	celebració
accolade	acolliment
terrorize	aterrorizar
shocking	impactant
significant	significatiu
rascal	malvat
motivated	motivat
spoonfed	cullerades
inequitable	inequitat
inhospitable	inhòspit
stiflingly	sofocant
overacted	sobreactuat
expulse	expulsar
tempting	temptadora
antipathy	antipatia
rhetoric	retòrica
shark	tauró
feasibly	factiblement
foe	enemic
hissing	xiuxiuejant
prohibitive	prohibitiu
mischievous	entremaliat
scuffs	raspalls
correct	correcte
mordantly	mordantment
denunciations	denúncies
evocative	evocador
insubordinate	insubordinat
disordered	desordenat
sincerely	sincerament
merrily	alegrement
polite	educat
derisiveness	despreocupació
blossom	florir
problematic	problemàtic
cleanliness	neteja
covenant	pacte
frightening	aterridor
violator	infractor
wrought	forjat
indiscriminate	indiscriminada
dizzy	mareig
crummy	cruel
scenic	escènic
retaliatory	represàlia
injustice	injustícia
devout	devot
slack	fluix
disable	desactivar
stuck	enganxat
depression	depressió
conspicuously	clarament
magical	màgic
inimically	enèrgicament
insurmountably	insuperablement
inexpertly	inexpert
scaly	escamós
stubbornly	obstinadament
reconcile	reconciliar
toll	peatge
heretic	heretge
downfall	caiguda
loneliness	solitud
inspiring	inspirador
oversights	descuits
prefered	preferit
cannibalize	canibalitzar
terrorism	terrorisme
safe	segur
glow	brillar
submissive	sotmès
wily	astut
enrapture	embotit
sickly	malalt
evenly	uniformement
overwhelmed	aclaparat
creative	creatiu
patience	paciència
fortitude	fortitud
multi-purpose	multiusos
discriminatory	discriminatori
top-heavy	pesat
spellbind	ortografia
noises	sorolls
revulsion	repulsió
liberation	alliberament
smartly	intel·ligentment
pretend	fingir
proprietary	propietari
violation	violació
beloved	estimat
geeky	geek
betrayals	traïcions
eschew	eviteu
apotheosis	apoteosi
qualified	qualificat
instability	inestabilitat
haphazard	atzar
inefficacious	ineficaç
overshadow	eclipsar
faith	fe
evildoer	malvat
desiccate	dessecar
abomination	abominació
concerned	preocupat
absence	absència
cautionary	precaució
conscientious	conscient
spiritual	espiritual
desperately	desesperadament
estranged	allunyat
sweetheart	amor
stooges	estripes
imprudence	imprudència
drunkard	borratxo
miserableness	miserable
renunciation	renúncia
bothersome	molest
dishonesty	deshonestedat
outrages	indignacions
mistakes	errades
venomously	verídicament
scoff	burlar-se
questionable	qüestionable
rant	esclat
brutish	brutal
slime	llot
relaxed	relaxat
rejects	rebutja
enhances	millora
upheld	mantingut
rejoicingly	alegrement
offend	ofendre
profanity	profanitat
downhearted	descoratjat
advanced	avançat
dull	avorrit
ripped	arrencat
insane	boig
drains	desguassos
beautifullly	bellesa
inadequately	inadequadament
betraying	traïció
pandemonium	pandemoni
wondrous	meravellós
setbacks	contratemps
dissolution	dissolució
excessive	excessiu
tawdry	taca
imperfections	imperfeccions
romantically	romànticament
inconvenience	inconveniència
overthrow	derrocar
obstinately	obstinadament
shady	ombrejat
straggle	estremir
awfulness	horrible
extraordinarily	extraordinàriament
qualify	qualificar
conceited	presumit
pain	dolor
wonderous	meravellós
ease	facilitat
renaissance	renaixença
resourcefulness	enginyós
accusingly	acusadament
intricate	complex
furious	furiós
desolate	desolat
bumpy	accidentat
ready	llest
wastefulness	desperdicio
capricious	capritxós
backwoods	llenyataires
faulty	defectuós
jubiliant	jubilant
empower	autoritzar
brilliances	brillants
disconcert	desconcert
fair	just
ultimatum	ultimàtum
ruthless	cruel
suffers	pateix
personages	personatges
pleased	satisfet
ineffectively	ineficaç
hiss	silenci
impaired	deteriorat
hype	bombo
depressingly	depriment
inequities	desigualtats
occluded	ocluït
authentic	autèntic
naïve	ingenu
run-down	aixafar
uncomfortable	incòmode
daunting	intimidant
acclaimed	aclamat
inflammed	inflamada
sore	dolor
adulteration	adulteració
favored	afavorit
stiff	rígid
stealing	robatori
extremism	extremisme
decline	disminució
alarming	alarmant
overthrows	derrotes
unmatched	inigualable
subversive	subversiu
renounce	renunciar
weaken	debilitar
hatred	odi
delusions	deliris
disregard	ignorar
damage	dany
calumny	calumnia
unwell	malestar
unsteadily	inoportú
exagerates	exagerats
despicable	despreciable
rusts	rovells
oppressiveness	opressivitat
mishap	contratemps
insensitively	insensiblement
romanticize	romanticitzar
mistrustfully	desconfiadament
respite	descans
thrills	emocions
destruction	destrucció
distract	distreure
snagged	enganxat
gravely	greu
resigned	resignat
damages	danys
enjoyable	agradable
oppressively	opressivament
maltreatment	maltractament
mawkishly	francament
cringe	encongir-se
stifle	sofocar
marveled	meravellat
breathlessness	inhalació
murder	assassinat
crumples	esclafeix
scarce	escàs
undone	desfeta
futurestic	futurisme
throttle	accelerador
dominates	domina
dismal	trist
stalls	parades
useable	utilitzable
spontaneous	espontani
savvy	intel·ligent
obstructed	obstruït
bright	brillant
encroachment	invasió
unhappy	infeliç
sinful	pecaminós
slogs	eslògans
smugly	presumiblement
leverage	apalancament
beautifully	bellament
tortured	torturat
suck	xuclar
vagrant	vagabund
scoundrel	canalla
dismalness	tristesa
confession	confessió
assault	assalt
satirical	satíric
sourly	Àcidament
uprising	aixecament
obscenity	obscenitat
hollow	buit
spewing	llançant
badly	malament
complaints	queixes
slaves	esclaus
woe	ai
taxing	impostos
blockbuster	superproducció
fascinating	fascinant
menacing	amenaçador
jubilantly	alegre
raptureously	còmicament
plagiarize	plagiar
hero	heroi
imperious	imperiós
obsessive	obsessiu
illegitimate	il·legítim
timidity	timidesa
misconception	equívoc
disdain	menyspreu
glorious	gloriós
extort	extorsionar
confounded	confosos
shameless	descarat
protracted	prolongada
discountenance	descentrat
repulsively	repulsivament
overemphasize	sobreemphasize
outperform	superat
smelly	dolorós
galls	galetes
apprehensive	aprensiu
pretentiously	pretensiós
glitches	fallades
cure	cura
overrated	sobrevalorat
deadly	mortal
recklessly	imprudentment
belittle	menyspreu
moot	discutible
avenge	venja
jolly	alegre
complication	complicació
truthfully	veritablement
slowly	lentament
tarnish	manchar
unfinished	inacabat
revolt	revolta
egotistically	egoista
impress	impressionar
thirst	set
reputation	reputació
repetitive	repetitiu
awed	sorprès
objections	objeccions
infamy	infamia
craps	dits
dangerousness	perillositat
warped	deformat
obtrusive	molest
miseries	misèries
fortunately	afortunadament
nervous	nerviós
involuntarily	involuntàriament
contention	contenció
distraught	distraído
repudiation	repudi
efficacious	eficaç
contravene	contravenen
happiness	felicitat
easiness	facilitat
mourner	morir
unexpected	inesperat
consternation	consternació
shortsighted	miopes
adoringly	adorant
worriedly	preocupat
passive	passiu
benevolence	benevolència
imprecision	imprecisió
difficulty	dificultat
bruise	moretones
grievously	greument
reaffirm	reafirmar
admire	admirar
engaging	atractiu
coarse	tosca
sloppily	descaradament
work	treballar
drain	desguàs
sunk	enfonsat
obsessiveness	obsessivitat
stingy	taca
abound	abunden
supportive	solidari
scared	espantat
disgustful	desagradable
cursed	maleït
edify	edificar
abusive	abusiu
throbs	empentes
incompatibility	incompatibilitat
disconsolation	disconsolació
inventive	inventiva
euphoric	eufòric
sulk	emmurriar-se
slick	taca
imposers	impositors
creeping	rastrero
harbors	ports
hang	penjar
accuses	acusa
bewitch	embruixar
fevers	febres
powerful	potent
straightforward	senzill
cronyism	cronisme
slump	caure
criticized	criticat
apathy	apatia
harm	danyar
devastates	devasta
rankle	ranxo
devastation	devastació
mistaken	equivocat
hawkish	picant
odor	olor
lousy	pèssim
transgress	transgredir
cataclysmically	cataclisme
exasperate	exasperat
dumps	abocadors
lowly	humil
eccentricity	excentricitat
insupportable	insuportable
privilege	privilegi
politeness	cortesia
stunned	atordit
sweetly	dolça
enfeeble	endeutament
draconic	draconi
immobilized	immobilitzat
scandals	escàndols
devastated	devastat
mawkishness	malvat
nettle	ortiga
slanderer	calumniador
delays	retards
infringement	infracció
bombardment	bombardeig
tumbles	caigudes
tenderness	tendresa
steadiness	estabilitat
insolence	insolència
stumble	ensopegar
drastic	dràstic
maladjustment	desajust
delight	delícia
demon	dimoni
byzantine	bizantí
delicate	delicat
enviable	envejable
zeal	zel
frighten	espantar
haunting	inquietant
effigy	efígie
puzzled	desconcertat
accomplish	aconseguir
repel	repel·lir
inevitably	inevitablement
irrationalities	irracionalitats
inconsistency	inconsistència
wickedness	maldat
defect	defecte
discontinuity	discontinuïtat
repugn	repudiar
affirm	afirmar
womanizing	femella
cripple	parapleja
enraptured	embrollat
sardonic	sardònics
rust	Òxid
sunken	enfonsat
beckoning	trucant
exhaustion	esgotament
inviolate	inviolada
dispiriting	despectiva
fanatics	fanàtics
disturb	molestar
pompous	pomposo
unsatisfactory	insatisfactori
bitingly	mossegant
falls	cau
creaks	crepes
cracks	esquerdes
compliant	compatible
furiously	furiosament
perversely	perversament
stunt	truc
offending	ofensiu
hardships	dificultats
extraordinary	extraordinari
excruciatingly	incrèdulament
stylish	elegant
inhumanity	inhumanitat
scathing	mordaç
fiction	ficció
betrayer	traïdor
leaking	fuites
junky	embruixat
slumping	saltant
truthful	verídica
hideously	horriblement
invigorating	vigoritzant
rabid	rabiós
dislocated	dislocat
sweetness	dolçor
adored	adorat
remedy	remei
repugnantly	repugnant
outbursts	esclats
limited	limitat
complicated	complicat
respect	respecte
buzzing	zumbido
drag	arrossegueu
titillatingly	titillant
ghosting	fantasma
easygoing	fàcil
capably	hàbilment
frightfully	espantós
admiring	admirant
astoundingly	sorprenentment
achievable	assolible
unspeakable	inefable
myth	mite
floundering	flotant
helplessness	impotència
captivating	cautivant
annoys	molesta
gallant	galant
gutter	canaló
creep	arrossegar-se
believable	creïble
flashy	cridaner
whores	putes
doomed	condemnat
insensitivity	insensibilitat
dissatisfaction	insatisfacció
responsive	sensible
pretense	pretensió
smelled	olorava
hotcake	brioix
mendacity	mendacitat
dire	calamitós
enjoys	gaudeix
breathtaking	impressionant
infections	infeccions
blunders	errors
disheartening	descoratjador
nourishing	alimentant
puppets	titelles
scary	asustadizo
forfeit	perdut
stellar	estel·lar
inundate	inundar
defeating	derrotant
loves	estima
plunderer	saquejador
longing	anhel
regression	regressió
fear	por
indoctrination	adoctrinament
blunder	error
like	m'agrada
contagious	contagiosa
prohibitively	prohibitivament
incredibly	increïblement
bugs	errors
annoyance	molèstia
impious	impius
ravage	estrip
entertaining	entretingut
spellbindingly	fascinant
expire	caducar
bolster	reforçar
suppression	supressió
lack	falta
irresistibly	irresistiblement
convincing	convincent
repulse	repulsa
accomodative	acollidor
crippling	trencant
drop-out	abandonament
adulterate	adulterat
distaste	distès
meager	pobre
heroize	heroïtzar
harshly	duresa
wellbeing	benestar
salutary	saludable
angel	àngel
obtuse	obtús
murky	tèrbol
discriminate	discriminar
peaceable	pacífica
impatient	impacient
tardy	tard
jubilate	jubilar
forged	forjat
subjection	subjecció
encroach	envair
humiliating	humiliant
castrated	castrat
spitefulness	escandalós
disavowal	desestimació
smiling	somrient
insufferably	insufriblement
classic	clàssic
unclear	incert
insinuate	insinuar
dismayingly	desagradable
blister	ampolla
confusing	confús
impressed	impressionat
notorious	notori
ill-treatment	maltractaments
dropout	abandonament
grudges	escates
encouragement	ànim
sarcastically	sarcàsticament
sagely	sagues
hallucinate	alucinar
-	-
very	molt
incredibly	increíblement
absolutely	absolutament
awfully	terriblement
enormously	enormement
extremely	extremadament
horribly	horriblement
seriously	seriament
pretty	bastant
too	massa
really	realment
most	més
more	més
-	-
no	no
not	no
can't	no
won't	no
doesn't no
don't	no
shouldn't	no
n't	no
didn't	no
couldn't	no
wouldn't	no
-	-
little	poc
enough	suficient
enough	suficientment
enough	bastant
enough	bastants
-	-
can	pot
could	podia
might	potser
might	pot
might	posiblement
should	deuria
