2-faces	2-caras
abnormal	anormal
abolish	abolir
abominably	abominablemente
abominate	abominar
abomination	abominación
abort	abortar
aborted	abortado
aborts	aborta
abound	abundar
abounds	abunda
abrade	desgastar
abrasive	abrasivo
abrupt	abrupto
abruptly	abruptamente
abscond	fugarse
absence	ausencia
absentee	ausente
absent-minded	distraído
absurd	absurdo
absurdity	absurdo
absurdly	absurdamente
abundance	abundancia
abundant	abundar
abuse	abuso
abused	abusado
abuses	abusos
abusive	abusivo
abysmal	abismal
abysmally	abismalmente
abyss	abismo
accessable	accesible
accessible	accesible
acclaim	aclamación
acclaimed	aclamado
acclamation	aclamación
accolade	premio
accolades	reconocimientos
accommodative	acomodaticia
accomodative	acomodativa
accomplished	cumplido
accomplish	lograr
accomplishment	logro
accomplishments	logros
accost	abordar
accurate	exacto
accurately	exacto
accursed	maldito
accusation	acusación
accusations	acusaciones
accuse	acusar
accuses	acusa
accusing	acusando
accusingly	acusatoriamente
acerbate	exacerbar
acerbic	acerbo
acerbically	mordacidad
ached	dolía
ache	dolor
aches	dolores
achievable	alcanzable
achievement	logro
achievements	logros
achievible	alcanzable
aching	dolor
acrid	acre
acridly	acremente
acrimonious	mordaz
acrimony	acritud
acumen	perspicacia
adamant	firme
adamantly	inflexiblemente
adaptive	adaptado
addict	adicto
addicted	adicto
addicting	adictivo
adequate	adecuado
adjustable	ajustable
admirably	admirablemente
admiration	admiración
admire	admirar
admirer	admirador
admiring	admirativo
admiringly	admirativamente
admonish	amonestar
admonisher	amonestador
admonishingly	admonitorio
admonishment	amonestación
admonition	advertencia
adore	adorar
adored	adorado
adorer	adorador
adoring	cariñoso
adroit	hábil
adroitly	diestramente
adulate	adular
adulation	adulación
adulatory	adulador
adulterate	adulterar
adulterated	adulterada
adulteration	adulteración
advanced	avanzado
advantageously	ventajosamente
advantageous	ventajoso
advantages	ventajas
advantage	ventaja
adventuresome	aventurero
adventurous	aventurero
adversarial	contradictorio
adversary	adversario
adverse	adverso
adversity	adversidad
advocate	defensor
advocated	propugnado
advocates	defensores
affability	afabilidad
affable	afable
affably	afablemente
affectation	afectación
affection	afecto
affectionate	cariñoso
affinity	afinidad
affirmation	afirmación
affirmative	afirmativo
afflict	afligir
affliction	aflicción
afflictive	doloroso
affluence	opulencia
affluent	afluente
affordable	asequible
affordably	asequible
afford	permitirse
affront	afrenta
afraid	miedo
aggravate	agravar
aggravating	agravante
aggravation	agravación
aggression	agresión
aggressive	agresivo
aggressiveness	agresividad
aggressor	agresor
aggrieved	agraviado
aggrieve	ofender
aghast	espantado
agile	ágil
agilely	ágilmente
agility	agilidad
agonies	agonías
agonize	agonizar
agonizing	agonizante
agonizingly	agonizantemente
agony	agonía
agreeable	agradable
agreeableness	agradabilidad
agreeably	agradablemente
aground	encallado
ail	afligir
ailing	enfermo
ailment	enfermedad
alarm	alarma
alarmed	alarmado
alarming	alarmante
alarmingly	alarmantemente
alienated	alienado
alienate	enajenar
alienation	alienación
all-around	total
allegation	allegatio
allegations	alegaciones
allege	alegar
allergic	alérgico
allergies	alergias
allergy	alergia
alluringly	seductoramente
alluring	seductor
altercation	altercado
altruistically	altruistamente
altruistic	altruista
amaze	asombrar
amazed	asombrado
amazement	asombro
amazes	sorprende
amazing	asombroso
amazingly	asombrosamente
ambiguity	ambigüedad
ambiguous	ambiguo
ambitious	ambicioso
ambitiously	ambiciosamente
ambivalence	ambivalencia
ambivalent	ambivalente
ambush	emboscada
ameliorate	mejorar
amenable	dócil
amenity	amenidad
amiability	amabilidad
amiable	amable
amicability	amabilidad
amicable	amistoso
amicably	amigablemente
amiss	mal
amity	amistad
ample	amplio
amply	ampliamente
amputate	amputar
amuse	divertir
amusing	divertido
amusingly	graciosamente
anarchism	anarquismo
anarchist	anarquista
anarchistic	anarquista
anarchy	anarquía
anemic	anémico
angel	ángel
angelic	angelical
anger	cólera
angrily	airadamente
angry	enojado
anguish	angustia
animosity	animosidad
annihilate	aniquilar
annihilation	aniquilación
annoyance	molestia
annoyances	molestias
annoyed	irritado
annoyingly	molestamente
annoying	molesto
annoy	molestar
annoys	late
anomalous	anómalo
anomaly	anomalía
antagonism	antagonismo
antagonist	antagonista
antagonistic	antagónico
antagonize	contrariar
anti-american	antiamericano
anti-israeli	anti-israelí
antipathy	antipatía
anti-proliferation	anti-proliferación
antiquated	anticuado
anti-semites	antisemitas
anti-social	antisocial
antithetical	antitético
anti-white	anti-blanco
anxieties	ansiedades
anxiety	ansiedad
anxious	ansioso
anxiously	ansiosamente
anxiousness	ansiedad
apathetically	apatía
apathetic	apático
apathy	apatía
apocalypse	apocalipsis
apocalyptic	apocalíptica
apologist	apologista
apologists	apologistas
apotheosis	apoteosis
appal	espantar
appalled	aterrado
appall	espantar
appalling	espantoso
appallingly	horriblemente
appeal	apelación
appealing	atractivo
applaud	aplaudir
appreciable	apreciable
appreciate	apreciar
appreciated	apreciado
appreciates	aprecia
appreciative	apreciativo
appreciatively	apreciativa
apprehension	aprensión
apprehensions	aprehensiones
apprehensive	aprensivo
apprehensively	aprensión
appropriate	apropiado
approval	aprobación
approve	aprobar
arbitrary	arbitrario
arcane	arcano
archaic	arcaico
ardent	ardiente
ardently	ardientemente
arduous	arduo
arduously	arduamente
argumentative	discutidor
arrogance	arrogancia
arrogant	arrogante
arrogantly	arrogantemente
articulate	articular
ashamed	avergonzado
asinine	asnal
asperse	hisopear
aspersion	aspersión
aspersions	aspersiones
aspiration	aspiración
aspirations	aspiraciones
aspire	aspirar
assail	atacar
assassin	asesino
assassinate	asesinar
assault	asalto
assurance	garantía
assurances	garantías
assure	asegurar
assuredly	ciertamente
assuring	asegurando
astonish	asombrar
astonished	sorprendido
astonishing	asombroso
astonishingly	asombrosamente
astonishment	asombro
astound	asombrar
astounded	asombrado
astounding	impresionante
astoundingly	pasmosamente
astutely	astutamente
atrocious	atroz
atrocities	atrocidades
atrocity	atrocidades
atrophy	atrofia
attack	ataque
attacks	ataques
attentive	atento
attraction	atracción
attractive	atractivo
attractively	atractivamente
attune	adaptar
audacious	audaz
audaciously	audazmente
audaciousness	audacia
audacity	audacia
auspicious	propicio
austere	austero
authentic	auténtico
authoritarian	autoritario
authoritative	autorizado
autocrat	autócrata
autocratic	autocrático
autonomous	autónomo
available	disponible
avalanche	avalancha
avarice	avaricia
avaricious	avaro
avariciously	avariciosamente
avenge	vengar
averse	contrario
aversion	aversión
avid	ávido
avidly	ávidamente
awarded	otorgado
award	premio
awards	premios
awesome	impresionante
awesomely	impresionantemente
awesomeness	genialidad
awestruck	atemorizado
awe	temor
awful	horrible
awfully	terriblemente
awfulness	horror
awkward	incómodo
awkwardness	torpeza
awsome	impresionante
ax	hacha
babble	balbuceo
backbite	murmurar
backbiting	murmuración
backwardness	atraso
back-wood	back-madera
back-woods	back-maderas
backwoods	rústico
badly	mal
bad	mal
bad	malo
baffled	desconcertado
baffle	deflector
bafflement	desconcierto
baffling	desconcertante
bait	cebo
balanced	equilibrado
balk	obstáculo
banalize	vulgarizar
bane	perdición
banish	desterrar
banishment	destierro
bankrupt	quebrado
barbarian	bárbaro
barbarically	bárbaramente
barbaric	bárbaro
barbarity	barbarie
barbarous	bárbaro
barbarously	bárbaramente
bargain	ganga
barren	bares
baseless	infundado
bash	fiesta
bashful	tímido
bashing	paliza
bastard	bastardo
bastards	bastardos
battered	maltratadas
battering	maltrato
batty	chalado
bearish	bajista
beastly	bestial
beauteous	hermoso
beautiful	hermoso
beautifully	hermosamente
beautify	embellecer
beauty	belleza
beckoned	señas
beckoning	señas
befoul	ensuciar
beggarly	miserable
beggar	mendigo
begging	mendicidad
beg	mendigar
beguile	engañar
belabor	apalear
belated	tardío
belie	desmentir
believable	creíble
belittled	menospreciado
belittle	empequeñecer
belittling	menosprecio
bellicose	belicoso
belligerence	beligerancia
belligerent	beligerante
beloved	amado
bemoan	lamentar
bemused	confundido
beneficent	benéfico
beneficially	beneficiosamente
beneficial	sano
beneficiary	beneficiario
benefit	beneficio
benefits	beneficios
benevolence	benevolencia
benevolent	benévolo
bent	doblado
berate	regañarse
bereavement	duelo
bereave	privar
bereft	privado
berserk	enloquecido
beseech	implorar
beset	acosar
besiege	sitiar
besmirch	manchar
best	mejor
betrayals	traiciones
betrayal	traición
betrayer	traidor
betraying	traicionero
betrays	traiciona
betray	traicionar
better	mejor
beutifully	hermosamente
bewail	llorar
bewilder	confundir
bewildered	desconcertado
bewildering	desconcertante
bewilderment	asombro
bewitch	hechizar
biased	parcial
biases	sesgos
bias	parcialidad
bigotries	intolerancias
bigotry	intolerancia
bitch	perra
bitchy	perra
bitingly	mordazmente
biting	mordaz
bitter	amargo
bitterness	amargura
bizarre	extraño
blabber	chismoso
blab	cotilla
blackmail	chantaje
blah	bla
blame	culpa
blameless	irreprochable
blameworthy	censurable
blandish	ablandar
bland	soso
blaspheme	blasfemar
blasphemous	blasfemo
blasphemy	blasfemia
blasted	maldito
blatant	descarado
blatantly	descaradamente
bleakly	desoladamente
bleakness	desolación
bleak	triste
bleeding	sangrado
bleed	sangrar
bleeds	sangra
blemish	mancha
bless	bendecir
blessing	bendición
blind	ciego
blinding	cegador
blindingly	cegador
bliss	felicidad
blissful	feliz
blissfully	felizmente
blister	ampolla
blistering	abrasador
blithe	alegre
bloated	hinchado
blockage	obstrucción
blockbuster	superproducción
blockhead	alcornoque
bloodthirsty	sanguinario
bloody	sangriento
bloom	floración
blossom	flor
blow	golpe
blunder	disparate
blundering	torpe
blunders	errores
blunt	embotado
blur	mancha
blurred	borrosa
blurring	desenfoque
blurry	borrosa
blurs	desenfoques
boastful	jactancioso
boggle	sobresaltarse
bogus	falso
boil	hervir
boiling	ebullición
boisterous	bullicioso
bolster	reforzar
bombard	bombardear
bombardment	bombardeo
bombastic	rimbombante
bomb	bomba
bondage	esclavitud
bonkers	loco
bonny	hermoso
bonuses	bonificaciones
bonus	prima
boom	auge
boost	impulsar
boredom	aburrimiento
bored	perforado
bores	taladros
bore	taladro
boring	aburrido
botch	chapucería
bothered	molestado
bothering	molesto
bother	molestar
bothers	molesta
bothersome	molesto
bountiful	abundante
bowdlerize	expurgar
boycott	boicoteo
braggart	fanfarrón
brainless	estúpido
brainy	inteligente
brand-new	flamante
brashness	desenvoltura
brash	temerario
bravado	bravata
bravery	valentía
brave	valiente
brazen	descarado
brazenly	descaradamente
brazenness	desfachatez
breach	incumplimiento
breakdown	desglose
breaking	rompiendo
break	pausa
breaks	descansos
breakthrough	ruptura
breakthroughs	avances
break-up	ruptura
breakup	ruptura
break-ups	rupturas
breakups	rupturas
breathlessness	disnea
breathtaking	asombroso
breathtakingly	impresionantemente
breeze	brisa
bribery	soborno
bright	brillante
brighten	aclarar
brilliance	brillantez
brilliances	brillos
brilliant	brillante
brilliantly	brillantemente
brimstone	azufre
brisk	enérgico
bristle	cerda
brittle	quebradizo
broken	roto
brood	cría
brotherly	fraternal
browbeat	atemorizar
bruise	contusión
bruised	magullado
bruises	contusiones
bruising	hematomas
brusque	brusco
brutalising	embrutecedor
brutalities	brutalidades
brutality	brutalidad
brutalize	embrutecer
brutalizing	embrutecedor
brutally	brutalmente
brute	bruto
brutish	brutal
buckle	hebilla
buggy	calesa
bugs	insectos
bulkiness	volumen
bulky	voluminoso
bullies	matones
bullish	alcista
bullshit	mierda
bullying	intimidación
bully	matón
bum	culo
bump	chichón
bumped	topado
bumping	chocar
bumps	golpes
bumpy	desigual
bungle	chapucear
bungler	chapucero
bungling	torpeza
bunk	litera
buoyant	boyante
burden	carga
burdensome	gravoso
burdensomely	pesadamente
burned	quemado
burning	ardiente
burn	quemar
burns	quemaduras
bust	busto
busts	bustos
busybody	entrometido
butcher	carnicero
butchery	carnicería
buzzing	zumbido
byzantine	bizantino
cackle	cacareo
cajole	engatusar
calamities	calamidades
calamitous	calamitoso
calamitously	horriblemente
calamity	calamidad
callous	calloso
calm	calma
calming	calmante
calmness	calma
calumniate	calumniar
calumniation	calumnia
calumnies	calumnias
calumnious	calumniosa
calumniously	calumniosa
calumny	calumnia
cancer	cáncer
cancerous	canceroso
cannibal	caníbal
cannibalize	canibalizar
capability	capacidad
capable	capaz
capably	competentemente
capitulate	capitular
capriciously	caprichosamente
capriciousness	capricho
capsize	zozobrar
captivate	cautivar
captivating	seductor
carefree	despreocupado
careless	descuidado
carelessness	descuido
caricature	caricatura
carnage	carnicería
carp	carpa
castigate	castigar
castrated	castrado
casualty	víctima
cataclysm	cataclismo
cataclysmically	cataclísmicamente
cataclysmic	catastrófico
catastrophe	catástrofe
catastrophes	catástrofes
catastrophically	catastróficamente
catastrophic	catastrófico
catastrophies	catástrofes
catchy	pegadizo
caustically	cáusticamente
caustic	cáustico
cautionary	advertencia
cave	cueva
celebrate	celebrar
celebrated	célebre
celebration	celebración
censure	censura
chafe	rozar
chaff	paja
chagrin	disgusto
challenging	desafiante
champion	campeón
chaos	caos
chaotic	caótico
charisma	carisma
charismatic	carismático
charitable	caritativo
charm	encanto
charming	encantador
charmingly	encantadoramente
chaste	casto
chasten	castigar
chastise	castigar
chastisement	castigo
chatterbox	charlatán
chatter	charla
cheap	barato
cheapen	abaratar
cheaply	barato
cheated	engañado
cheat	engañar
cheater	tramposo
cheating	trampa
cheats	tramposos
cheerful	alegre
cheer	humor
cheerless	triste
cheery	alegre
cheesy	caseoso
cherish	apreciar
cherished	querido
cherub	querubín
chic	elegante
childish	infantil
chill	frío
chilly	frío
chivalrous	caballeroso
chivalry	caballería
choke	estrangulación
choleric	colérico
choppy	picado
chore	faena
chronic	crónico
chunky	fornido
civility	civilidad
civilize	civilizar
clamorous	clamoroso
clarity	claridad
clash	choque
classic	clásico
cleaner	limpiador
clean	limpio
cleanliness	limpieza
cleanly	limpiamente
clear	claro
cleared	despejado
clearly	claramente
clears	ocurre
clever	inteligente
cleverly	inteligentemente
cliche	cliché
cliched	cliché
clique	camarilla
clogged	obstruido
clogs	zuecos
clog	zueco
clouding	opacidad
cloud	nube
cloudy	nublado
clueless	despistados
clumsy	torpe
clunky	torpe
coarse	grueso
cocky	gallito
coerce	obligar
coercion	coacción
coercive	coactivo
coherence	coherencia
coherent	coherente
cohesive	cohesivo
cold	frío
coldly	fríamente
collapse	colapso
collude	confabularse
collusion	colusión
colorful	colorido
combative	combativo
comely	gentil
comfortable	cómodo
comfortably	cómodamente
comfort	confort
comforting	consolador
comfy	confortable
comical	cómico
commendable	recomendable
commendably	encomiable
commend	encomendar
commiserate	compadecer
commitment	compromiso
commonplace	vulgar
commotion	conmoción
commotions	conmociones
compact	compacto
compactly	compacta
compassionate	compasivo
compassion	compasión
competitive	competitivo
complacent	complaciente
complained	quejado
complaining	quejarse
complain	quejarse
complaint	queja
complaints	quejas
complementary	complementario
complement	complemento
complemented	complementado
complements	complementos
complex	complejo
compliant	obediente
complicated	complicado
complication	complicación
complicit	complicita
complimentary	cortesía
compliment	cumplido
comprehensive	exhaustivo
compulsion	compulsión
compulsive	compulsivo
concede	conceder
conceded	concedido
conceited	presumido
conceit	presunción
concen	concan
concerned	preocupado
concern	preocupación
concerns	preocupaciones
concession	concesión
concessions	concesiones
conciliate	conciliar
conciliatory	conciliador
concise	conciso
condemnable	condenable
condemnation	condenación
condemn	condemi
condemned	condenado
condemns	condena
condescend	condescender
condescending	condescendiente
condescendingly	condescendientemente
condescension	condescendencia
confess	confesar
confession	confesión
confessions	confesiones
confidence	confianza
confident	confiado
confined	confinado
conflict	conflicto
conflicting	contradictorio
conflicts	conflictos
confound	confundir
confounded	confundido
confounding	confusión
confrontational	confrontación
confrontation	confrontación
confront	criminal
confuse	confuso
confused	confundido
confuses	confunde
confusing	confuso
confusion	confusión
confusions	confusiones
congenial	agradable
congested	congestionado
congestion	congestión
congratulate	felicitar
congratulation	felicitación
congratulations	felicitaciones
congratulatory	congratulatorio
conscientious	concienzudo
cons	contras
conservative	conservador
considerate	considerado
consistent	consistente
consistently	consecuentemente
conspicuous	conspicuo
conspicuously	deberes
conspiracies	conspiraciones
conspiracy	conspiración
conspirator	conspirador
conspiratorial	conspirador
conspire	conspirar
consternation	consternación
constructive	constructivo
consummate	consumado
contagious	contagioso
contaminate	contaminar
contaminated	contaminado
contaminates	contaminantes
contaminating	contaminar
contamination	contaminación
contempt	desprecio
contemptible	despreciable
contemptuous	despreciativo
contemptuously	desdeñosamente
contend	contender
contention	contención
contentious	contencioso
contentment	alegría
continuity	continuidad
contortions	contorsiones
contort	retorcer
contradict	contador
contradiction	contradicción
contradictory	contradictorio
contrariness	contrariedad
contrasty	contrastada
contravene	infringir
contribution	contribución
contrived	artificial
contrive	idear
controversial	polémico
controversy	controversia
convenience	conveniencia
convenient	conveniente
conveniently	convenientemente
convience	conveniencia
convient	práctico
convincing	convincente
convincingly	convincentemente
convoluted	complejo
cool	fresco
cooperative	cooperativa
cooperatively	cooperativamente
correct	correcto
correctly	correctamente
corrode	corroer
corrosion	corrosión
corrosions	corrosiones
corrosive	corrosivo
corrupt	corrupto
corrupted	corrompido
corrupting	corruptor
corruption	corrupción
corrupts	corrompe
cost-effective	rentable
costly	costoso
counter-attack	contraataque
counter-attacks	contraataques
counter-productive	contraproducente
counterproductive	contraproducente
coupists	golpistas
courage	coraje
courageously	valientemente
courageousness	valentía
courteous	cortés
courtly	cortés
covenant	pacto
covetous	codicioso
coward	cobarde
cowardly	cobarde
cozy	cosy
crabby	malhumorados
cracked	agrietado
crack	grieta
cracks	grietas
craftily	astutamente
craftly	artesanalmente
crafty	astuto
cramp	calambre
cramped	estrecho
cramping	calambres
cranky	irritable
crap	mierda
craps	dados
crash	choque
crashed	estrellado
crashes	accidentes
crashing	estrellarse
crass	craso
craven	cobarde
cravenly	cobardemente
craze	manía
crazily	locamente
craziness	locura
crazy	loco
creak	crujido
creaking	crujiente
creaks	cruje
creative	creativo
credible	creíble
credulous	crédulo
creep	arrastrarse
creeping	progresivo
creeps	grima
creepy	horripilante
crept	deslizado
crime	crimen
cringe	encogerse
crippled	lisiado
cripples	lisiados
crippling	paralizante
crisp	crujiente
crisper	rizador
critical	crítico
critic	crítico
criticism	crítica
criticisms	críticas
criticize	criticar
criticized	criticado
criticizing	criticar
critics	críticos
cronyism	amiguismo
crooked	torcido
crook	ladrón
crooks	ladrones
crowdedness	hacinamiento
crude	crudo
cruelties	crueldades
cruelty	crueldad
crumble	desmoronarse
crumbling	desmoronamiento
crumple	arrugarse
crumpled	arrugado
crumples	arruga
crush	aglomeración
crushed	aplastado
crushing	aplastante
cry	grito
culprit	culpable
cumbersome	incómodo
cunt	coño
cunts	coños
cure-all	panacea
cure	cura
cursed	maldito
curse	maldición
curses	maldiciones
curt	brusco
cushy	cómodo
cussed	terco
cuss	maldecir
cute	lindo
cuteness	monería
cutthroat	asesino
cynical	cínico
cynicism	cinismo
damage	daño
damaged	estropeado
damaging	perjudicial
damnable	detestable
damnably	detestablemente
damnation	condenación
damned	maldito
damning	condenatorio
damn	maldito
damper	apagador
dangerousness	peligrosidad
dangerous	peligroso
danger	peligro
danke	gracias
danken	húmedo
daring	atrevido
daringly	atrevidamente
darkened	oscurecido
darken	oscuro
darkness	oscuridad
dark	oscuro
darling	querido
dashing	gallardo
dastardly	ruin
daunt	acobardar
daunting	desalentadora
dauntingly	intimidantemente
dauntless	impávido
dawdle	holgazanear
dawn	amanecer
daze	aturdimiento
dazed	aturdido
dazzled	deslumbrado
dazzle	deslumbrar
dazzling	deslumbrante
deadbeat	perezoso
deadly	mortal
dead	muerto
deaf	sordo
dearth	escasez
death	muerte
debase	degradar
debasement	humillación
debatable	discutible
debauchery	libertinaje
debilitate	debilitar
debilitating	debilitante
debility	debilidad
debt	deuda
debts	deudas
decadence	decadencia
decadent	decadente
decay	decadencia
decayed	deteriorado
deceit	engaño
deceitful	engañoso
deceitfully	engañosamente
deceitfulness	engaño
deceive	engañar
deceiver	engañador
deceivers	engañadores
deceiving	engañoso
decency	decencia
decent	bueno
deception	engaño
deceptive	engañoso
deceptively	engañosamente
decisive	decisivo
decisiveness	decisión
declaim	declamar
decline	disminución
declines	descensos
declining	declinante
decrement	decremento
decrepit	decrépito
decrepitude	decrepitud
decry	censurar
dedicated	dedicado
defamation	difamación
defamations	difamaciones
defamatory	difamatorio
defame	difamar
defeat	derrota
defeating	derrotar
defeats	derrotas
defect	defecto
defective	defectuoso
defects	defectos
defender	defensor
defensive	defensiva
deference	deferencia
defiance	desafío
defiant	desafiante
defiantly	desafiante
deficiencies	deficiencias
deficiency	deficiencia
deficient	deficiente
defile	profanar
defiler	profanador
deform	deformar
deformed	deformado
defrauding	defraudar
deft	hábil
defunct	difunto
defy	desafiar
degenerate	degenerado
degeneration	degeneración
degradation	degradación
degrade	degradar
degrading	degradante
degradingly	degradantemente
dehumanization	deshumanización
dehumanize	deshumanizar
deign	dignarse
dejected	abatido
dejectedly	abatido
dejection	abatimiento
deject	presar
delayed	retrasado
delaying	dilatoria
delay	retraso
delays	retraso
delectable	deleitable
delicacy	delicadeza
delicate	delicado
delicious	delicioso
delight	deleite
delighted	encantado
delightful	encantador
delightfully	deliciosamente
delinquency	delincuencia
delinquent	delincuente
delirious	delirante
delirium	delirio
deluded	iluso
delude	engañarse
deluge	diluvio
delusional	delirante
delusion	ilusión
delusions	ilusiones
demean	degradar
demeaning	degradante
demise	fallecimiento
demolish	demoler
demolisher	demoledor
demon	demonio
demonic	demoníaco
demonized	demonizado
demonize	demonizar
demonizes	demoniza
demonizing	demonización
demoralize	desmoralizar
demoralizing	desmoralizador
denial	negación
denied	negado
denies	niega
denigrate	denigrar
denounce	denunciar
dense	compacto
dent	abolladura
dented	abollado
dents	abolladuras
denunciate	denunciar
denunciation	denuncia
denunciations	denuncias
denying	negando
deny	negar
dependable	confiable
dependably	fiable
deplete	agotar
deplorably	deplorablemente
deplore	deplorar
deploring	deplorando
depraved	depravado
deprave	depravar
deprecate	desaprobar
depress	deprimir
depressed	deprimido
depressing	deprimente
depressingly	depresivamente
depression	depresión
depressions	depresiones
deprived	privado
deprive	privar
deride	ridiculizar
derision	burla
derisive	burlón
derisively	burlonamente
derogatory	despectivo
desecrate	profanar
desert	desierto
desertion	deserción
deservedly	merecidamente
deserving	digno
desiccated	desecado
desiccate	desecar
desirable	deseable
desiring	desear
desirous	deseoso
desolately	tristemente
desolate	solitario
desolation	soledad
despair	desesperación
despairing	desesperado
despairingly	desesperadamente
desperate	desesperado
desperately	desesperadamente
desperation	desesperación
despicable	despreciable
despicably	vilmente
despised	despreciado
despise	despreciar
despoil	despojar
despoiler	despojador
despondence	desaliento
despondency	abatimiento
despondent	abatido
despondently	desaliento
despot	déspota
despotic	despótico
despotism	despotismo
destabilisation	desestabilización
destiny	destino
destitute	indigente
destitution	miseria
destroy	destruir
destroyer	destructor
destruction	destrucción
destructive	destructivo
desultory	inconexo
detachable	desmontable
deter	disuadir
deteriorate	deteriorarse
deteriorating	deterioro
deterioration	putrefacción
deterrent	disuasivo
detestably	detestablemente
detest	detestar
detested	detestado
detesting	detestando
detests	detesta
detract	detraer
detracted	detraído
detracting	desmerecer
detraction	detracción
detracts	detrae
detrimental	perjudicial
detriment	detrimento
devastated	devastado
devastate	devastar
devastates	arrasa
devastating	devastador
devastatingly	devastadoramente
devastation	devastación
deviate	desviarse
deviation	desviación
devil	diablo
devilish	diabólico
devilishly	diabólicamente
devilment	diablura
devilry	diablura
deviously	sinuosamente
deviousness	desviación
devious	tortuoso
devoid	vacío
devout	devoto
dexterous	diestro
dexterously	diestramente
dextrous	diestro
diabolical	diabólico
diabolically	diabólicamente
diabolic	diabólico
diametrically	diametralmente
diatribe	diatriba
diatribes	diatribas
dick	polla
dictator	dictador
died	muerto
die-hard	empedernido
die	morir
dies	muere
difficult	difícil
difficulties	dificultades
difficulty	dificultad
diffidence	timidez
dignified	digno
dignify	dignificar
dignity	dignidad
dilapidated	arruinado
dilemma	dilema
diligence	diligencia
diligent	diligente
diligently	diligentemente
dim	apagarse
din	estruendo
dings	abolladuras
diplomatic	diplomático
dire	calamitoso
direly	imperiosamente
dirts	suciedades
dirt	suciedad
dirty	sucio
disabled	discapacitado
disable	inhabilitar
disaccord	desacuerdo
disadvantage	desventaja
disadvantaged	perjudicado
disadvantageous	desventajoso
disadvantages	desventajas
disaffect	desafectar
disaffected	desafecto
disaffirm	testar
disagreeable	desagradable
disagreeably	desagradablemente
disagreeing	desacuerdo
disagreement	desacuerdo
disallow	rechazar
disapointed	decepcionado
disapointing	decepcionante
disapointment	decepción
disappoint	decepcionar
disappointed	decepcionado
disappointing	decepcionante
disappointingly	decepcionantemente
disappointment	decepción
disappointments	decepciones
disappoints	decepciona
disapprobation	desaprobación
disapproval	desaprobación
disapprove	desaprobar
disapproving	desaprobación
disarm	desarmar
disarray	desorden
disaster	desastre
disasterous	desastroso
disastrous	desastroso
disastrously	desastrosamente
disavowal	desautorización
disavow	desautorizar
disbelief	incredulidad
disbeliever	incrédulo
disclaim	renunciar
discomfort	dolor
discompose	descomponer
disconcert	desconcertar
disconcerted	desconcertado
disconcerting	desconcertante
disconcertingly	desconcertantemente
disconsolate	desconsolado
disconsolately	desconsoladamente
disconsolation	desconsuelo
discontent	descontento
discontented	descontento
discontinued	discontinuado
discontinuity	discontinuidad
discontinuous	discontinuo
discordance	discordancia
discordant	discordante
discord	discordia
discountenance	desaprobar
discourage	desalentar
discouragement	desaliento
discouraging	desalentador
discouragingly	desalentadoramente
discourteous	descortés
discourteously	descortesía
discredit	desacreditar
discrepant	discrepante
discriminate	discriminar
discrimination	discriminación
discriminatory	discriminatorio
disdain	desdén
disdained	desdeñado
disdainful	desdeñoso
disdainfully	desdeñosamente
disfavor	desfavorecer
disgrace	desgracia
disgracefully	vergonzosamente
disgraceful	vergonzoso
disgruntled	descontento
disgruntle	disgustar
disgust	asco
disgusted	disgustado
disgustedly	disgusto
disgustful	repulsivas
disgustingly	asquerosamente
disgusting	repugnante
dishearten	descorazonar
disheartening	descorazonador
dishearteningly	descorazonadoramente
dishonest	deshonesto
dishonestly	deshonestamente
dishonesty	deshonestidad
dishonorable	deshonroso
dishonor	deshonor
disillusion	desilusión
disillusioned	desilusionado
disillusionment	desilusión
disillusions	desilusiones
disinclination	aversión
disingenuous	falso
disintegrated	desintegrado
disintegrate	desintegrarse
disintegrates	desintegra
disintegration	desintegración
disinterest	desinterés
disinterested	desinteresado
dislike	aversión
dislikes	disgustos
disliking	desagrado
dislocated	dislocado
disloyal	desleal
disloyalty	deslealtad
dismally	tristemente
dismal	triste
dismay	consternación
dismayed	consternados
dismaying	desalentador
dismayingly	desalentadoramente
dismissive	desdeñoso
dismissively	despectivamente
disobedient	desobediente
disobey	desobedecer
disordered	desordenado
disorderly	desordenado
disorder	trastorno
disorganized	desorganizado
disorient	desorientar
disoriented	desorientado
disown	repudiar
disparage	menospreciar
disparaging	despectivo
disparagingly	despectivamente
dispirit	desalentar
dispirited	desalentado
dispiritedly	desánimo
displaced	desplazado
displeased	disgustado
displease	desagradar
displeasing	desagradable
displeasure	desagrado
disproportionate	desproporcionado
disprove	refutar
disputed	disputa
dispute	disputa
disquiet	desasosiego
disquieting	inquietante
disquietingly	inquietante
disquietude	desasosiego
disregard	indiferencia
disrespectful	irrespetuoso
disrespectfully	irrespetuosamente
disrespecting	irrespetando
disrupt	interrumpir
disruption	trastorno
disruptive	disruptivo
dissapointed	decepcionado
dissappointing	decepcionante
dissatisfaction	insatisfacción
dissatisfied	insatisfecho
dissatisfies	ordissatisfies
dissatisfy	descontentar
dissemble	disimular
dissembler	disimulador
dissension	disensión
dissent	disidencia
dissenter	disidente
dissention	discordia
disservice	deservicio
dissidence	manzana
dissident	disidente
dissidents	disidentes
dissocial	disociable
dissolute	disoluto
dissolution	disolución
dissonance	disonancia
dissonant	disonante
dissonantly	disonantemente
dissuade	disuadir
dissuasive	disuasivo
distaste	disgusto
distasteful	desagradable
distastefully	desagrado
distinction	distinción
distinctive	distintivo
distinguished	distinguido
distort	distorsionar
distorted	distorsionado
distortion	distorsión
distorts	distorsiona
distract	distraer
distracting	distracción
distraction	distracción
distraught	loco
distress	angustia
distressed	angustiado
distressing	angustioso
distressingly	penosamente
distrust	desconfianza
distrustful	desconfiado
distrusting	desconfiando
disturbance	perturbación
disturbed	perturbado
disturbingly	perturbadoramente
disturbing	perturbador
disturb	perturbar
disunity	desunión
disvalue	disvalor
divergent	divergente
diversified	diversificado
divine	divino
divinely	divinamente
divisive	divisivo
divisiveness	divisionismo
dizzy	mareado
doddering	chocho
doggedly	tenazmente
dogged	obstinado
dogmatic	dogmático
doldrums	bache
dominate	conquista
dominated	dominado
dominates	domina
domineering	dominador
domineer	tiranizar
doomed	condenado
doom	perdición
dope	droga
dote	adorar
doubt	duda
doubtful	dudoso
doubtless	indudable
doubts	dudas
downbeat	pesimista
downcast	alicaído
downfall	caída
downgrade	degradar
downhearted	desanimado
downside	desventaja
downsides	desventajas
downturn	recesión
downturns	recesiones
drab	monótono
draconian	draconiana
draconic	dracónica
drag	arrastrar
dragged	arrastrado
dragging	arrastrando
dragoon	dragón
drags	arrastra
drain	drenar
drained	agotado
draining	drenaje
drains	desagües
drastically	drásticamente
drastic	drástico
drawback	inconveniente
drawbacks	inconvenientes
dreadfully	horrorosamente
dreadful	terrible
dread	temer
dreary	triste
dripped	goteado
dripping	goteo
drippy	pegajosa
drips	goteos
droop	caer
droops	cae
dropout	deserción
drop-outs	abandonos
dropouts	abandonos
drought	sequía
drowning	ahogo
drunkard	borracho
drunk	borracho
drunken	borracho
dubious	dudoso
dubiously	dudosamente
dud	falso
dull	aburrido
dullard	zoquete
dumbfounded	estupefacto
dumb	mudo
dumps	vertederos
dump	vertedero
dunce	burro
dungeon	mazmorra
dungeons	mazmorras
dupe	incauto
durable	duradero
dust	polvo
dusty	polvoriento
dwindling	menguante
dying	moribundo
dynamic	dinámico
eager	ansioso
eagerly	ansiosamente
eagerness	afán
earnestly	formalmente
earnestness	seriedad
earnest	serio
eased	aliviado
ease	facilidad
eases	facilita
easiness	facilidad
easing	aliviando
easy	fácil
easygoing	acomodadizo
ebullience	entusiasmo
ebullient	exuberante
eccentric	excéntrico
eccentricity	excentricidad
economical	económico
ecstasies	éxtasis
ecstasy	éxtasis
ecstatically	éxtasis
ecstatic	extático
edify	edificar
educated	educado
effective	efectivo
effectively	eficazmente
effectiveness	efectividad
effectual	eficaz
efficacious	eficaz
efficient	eficiente
efficiently	eficientemente
effigy	efigie
effortless	fácil
effortlessly	permitiendo
effrontery	descaro
effusion	efusión
effusive	efusivo
effusively	efusivamente
effusiveness	efusividad
egocentric	egocéntrico
egomania	egomanía
egotism	egotismo
egotistical	ególatra
egotistically	egoístamente
egregious	enorme
egregiously	notoriamente
elated	exaltado
elate	regocijado
elation	elación
election-rigger	elecciones-instalador
electrify	electrizar
elegance	elegancia
elegant	elegante
elegantly	elegantemente
elevate	elevar
elimination	eliminación
elite	élite
eloquence	elocuencia
eloquently	elocuentemente
emaciated	demacrado
emasculate	castrar
embarrass	avergonzar
embarrassing	embarazoso
embarrassingly	vergonzosamente
embarrassment	vergüenza
embolden	envalentonar
embroiled	embrollado
embroil	embrollar
embroilment	embrollo
emergency	emergencia
eminence	eminencia
eminent	eminente
empathize	empatizar
empathy	empatía
emphatically	enfáticamente
emphatic	enfático
empower	autorizar
emptiness	vacío
enchant	encantar
enchanting	encantador
encourage	fomentar
encouragement	estímulo
encouraging	alentador
encouragingly	alentador
encroachment	usurpación
encroach	usurpar
endearing	entrañable
endorsed	endosado
endorse	endosar
endorsement	endoso
endorses	respalda
endorsing	endosar
enemies	enemigos
enemy	enemigo
energetic	energético
energize	energizar
enervate	enervar
enfeeble	debilitar
enflame	inflamar
engrossing	absorbente
engulf	tragarse
enhanced	mejorado
enhance	mejorar
enhancement	realce
enhances	mejora
enjoin	ordenar
enjoyable	agradable
enjoyably	divertida
enjoy	disfrutar
enjoyed	disfrutado
enjoying	disfrutando
enjoyment	disfrute
enjoys	disfruta
enlighten	iluminar
enlightenment	ilustración
enliven	animar
enmity	enemistad
ennoble	ennoblecer
enough	suficiente
enraged	enfurecido
enrage	enfurecer
enraging	enfurecedora
enrapture	arrebatar
enraptured	embelesado
enrich	enriquecer
enrichment	enriquecimiento
enslave	esclavizar
entangle	enredar
entanglement	enredo
enterprising	emprendedor
entertain	entretener
entertaining	entretenido
entertains	entretiene
enthral	cautivar
enthrall	cautivar
enthralled	cautivados
enthuse	entusiasmar
enthusiasm	entusiasmo
enthusiast	entusiasta
enthusiastic	entusiasta
entice	atraer
enticed	atraídos
enticingly	seductoramente
enticing	tentador
entrancing	fascinante
entrap	entrampar
entrapment	atrapamiento
entrust	confiar
enviable	envidiable
enviably	envidiablemente
envious	envidioso
enviously	envidiosamente
envy	envidia
epidemic	epidemia
equitable	equitativo
equivocal	equívoco
erase	borrar
ergonomical	ergonómico
erode	erosionar
erodes	erosiona
erosion	erosión
errant	errante
erratically	erráticamente
erratic	errático
err	errar
erroneous	erróneo
erroneously	erróneamente
errors	errores
erudite	erudito
eruptions	erupciones
escapade	escapada
eschew	evitar
estranged	distanciado
ethical	ético
eulogize	elogiar
euphoria	euforia
euphorically	eufóricamente
euphoric	eufórico
evade	evadir
evaluative	evaluativo
evasion	evasión
evasive	evasivo
evenly	igualmente
eventful	memorable
everlasting	eterno
evildoer	malhechor
evil	mal
evils	males
eviscerate	destripar
evocative	evocador
exacerbate	exacerbar
exagerated	exagerada
exaggerate	exagerar
exaggeration	exageración
exaltation	exaltación
exalted	exaltado
exaltedly	exaltadamente
exalt	exaltar
exalting	exaltando
exasperated	exasperada
exasperate	exasperar
exasperating	irritante
exasperatingly	exasperantemente
exasperation	exasperación
exceeded	excedido
exceed	exceder
exceeding	exceda
exceedingly	excesivamente
exceeds	excede
excelent	excelente
excellant	excelente
excelled	sobresalido
excellence	excelencia
excellency	excelencia
excellent	excelente
excellently	excelentemente
excel	sobresalir
excels	sobresale
exceptional	excepcional
exceptionally	excepcionalmente
excessive	excesivo
excessively	excesivamente
excited	excitado
excite	excitar
excitement	emoción
excites	excita
exciting	emocionante
excitingly	emocionante
exclusion	exclusión
excoriate	excoriar
excruciating	agudísimo
excruciatingly	insoportablemente
excuse	excusa
excuses	excusas
execrate	execrar
exellent	excelente
exemplar	ejemplar
exemplary	ejemplar
exhausted	agotado
exhaust	escape
exhaustion	agotamiento
exhilarate	regocijar
exhilarating	estimulante
exhilaration	regocijo
exhorbitant	exorbitante
exhort	exhortar
exile	exilio
exonerate	exonerar
exorbitant	exorbitante
exorbitantly	exorbitantemente
expansive	expansivo
expeditiously	expedita
expel	expulsar
expensive	caro
expertly	experta
expire	caducar
expired	caducado
explode	explotar
exploitation	explotación
exploit	explotar
explosive	explosivo
expropriate	expropiar
expropriation	expropiación
expulse	expulsar
expunge	borrar
exquisite	exquisito
exquisitely	exquisitamente
exterminate	exterminar
extermination	exterminio
extinguish	destruir
extol	ensalzar
extoll	ensalzar
extort	extorsionar
extortion	extorsión
extraneous	extraño
extraordinarily	extraordinariamente
extraordinary	extraordinario
extravagance	extravagancia
extravagant	extravagante
extravagantly	extravagantemente
extremism	extremismo
extremist	extremista
extremists	extremistas
exuberance	exuberancia
exuberant	exuberante
exuberantly	exuberantemente
exultant	jubiloso
exultation	exultación
exult	exultar
exultingly	exultantes
eye-catching	llamativo
eyecatching	llamativo
eye-catch	ojo-captura
eyesore	monstruosidad
fabricate	fabricar
fabrication	fabricación
fabulous	fabuloso
fabulously	fabulosamente
facetious	chistoso
facilitate	facilitar
failed	fracasado
fail	fallar
failing	defecto
fails	falla
failure	fracaso
failures	fracasos
faint	débil
fair	feria
fairly	bastante
fairness	justicia
faith	fe
faithful	fiel
faithfully	fielmente
faithfulness	fidelidad
faithless	desleal
fake	falso
fallacies	falacias
fallacious	erróneo
fallaciously	falsamente
fallaciousness	falacia
fallacy	falacia
fall	caer
fallen	caído
falls	caídas
false	falso
falsehood	falsedad
falsely	falsamente
falsify	falsificar
falter	desfallecer
faltered	tambaleado
famed	famoso
fame	fama
famine	hambre
famished	famélico
famous	famoso
famously	famosamente
fanatical	fanático
fanatically	fanáticamente
fanatic	fanático
fanaticism	fanatismo
fanatics	fanáticos
fancier	criador
fanciful	imaginario
fancy	fantasía
fanfare	fanfarria
fans	ventiladores
fantastically	fantásticamente
fantastic	fantástico
farce	farsa
farcical	absurdo
farcically	grotescamente
farfetched	rebuscado
fascinate	fascinar
fascinating	fascinante
fascinatingly	fascinantemente
fascination	fascinación
fascism	fascismo
fascist	fascista
fastidious	fastidioso
fastidiously	fastidiosamente
fast-paced	acelerado
fast	rápido
fastuous	fastuoso
fatalistically	fatalistamente
fatalistic	fatalista
fatally	fatalmente
fateful	fatídico
fatefully	fatídicamente
fat	grasa
fathomless	insondable
fatigued	fatigado
fatigue	fatiga
fatty	graso
fatuity	fatuidad
fatuous	fatuo
fatuously	fatuamente
fault	culpa
faultless	impecable
faults	fallas
faulty	defectuoso
favored	favorecido
favor	favorecer
favorited	favorito
favorite	favorito
favour	favorecer
fawningly	servilmente
faze	perturbar
fearful	temeroso
fear	miedo
fearsome	temible
fears	temores
feasible	factible
feasibly	factiblemente
feat	hazaña
feckless	irresponsable
feeble	débil
feign	fingir
feint	finta
feisty	luchadora
felicitate	felicitar
felicitous	feliz
felicity	dicha
felon	delincuente
felonious	criminal
ferociously	ferozmente
ferocity	ferocidad
fertile	fértiles
fervent	ferviente
fervently	fervorosamente
fervid	ardiente
fervidly	fervientemente
festive	festivo
fetid	fétido
fever	fiebre
feverish	febril
fevers	fiebres
fibber	mentiroso
fickle	voluble
fictional	ficticio
fiction	ficción
fictitious	ficticio
fidelity	fidelidad
fidget	agitarse
fidgety	nervioso
fiend	demonio
fiendish	diabólico
fierce	feroz
fiery	ardiente
figurehead	testaferro
filth	inmundicia
filthy	inmundo
fine	fino
finely	finamente
finer	finlandés
finicky	melindroso
fissures	fisuras
fist	puño
flabbergasted	asombrado
flagging	marcar
flagrant	flagrante
flagrantly	notoriamente
flair	instinto
flairs	ensanchamientos
flake	escama
flakey	escamosa
flaking	descamación
flaky	escamoso
flare	llamarada
flares	bengalas
flashy	ostentoso
flatter	halagar
flattering	halagüeño
flatteringly	halagadoramente
flaunt	ostentar
flawed	defectuoso
flaw	falla
flawless	perfecto
flaws	defectos
flee	huir
fleeing	huyendo
flees	huye
fleeting	fugaz
flexibility	flexibilidad
flickering	parpadeo
flicker	parpadeo
flickers	parpadeos
flighty	frívolo
flimsy	endeble
flirt	coquetear
flirty	coqueta
floored	solado
floundering	forcejeo
flounder	platija
flourish	florecer
flourishing	floreciente
fluent	fluido
fluster	aturdir
flutter	aleteo
foe	enemigo
fond	aficionado
fondly	afectuosamente
fondness	afición
fool	engañar
foolhardy	temerario
foolishly	neciamente
foolishness	necedad
foolish	tonto
forbidden	prohibido
forbidding	prohibiendo
forbid	prohibir
forceful	enérgico
foreboding	presentimiento
foremost	primero
foresight	previsión
forfeit	perder
forged	falsificado
forgetfulness	olvido
forgetful	olvidadizo
forlorn	abandonado
forsake	abandonar
forsaken	abandonado
forswear	abjurar
fortitude	fortaleza
fortuitous	fortuito
fortuitously	fortuitamente
fortunate	afortunado
fortunately	afortunadamente
fortune	fortuna
foul	falta
foully	asquerosamente
foulness	asquerosidad
fractious	díscolo
fracture	fractura
fragile	frágil
fragmented	fragmentado
fragrant	fragante
frail	frágil
frantically	frenéticamente
frantic	frenético
franticly	frenéticamente
fraud	fraude
fraudulent	fraudulento
fraught	tenso
frazzled	agotado
freaking	maldita
freakish	anormal
freakishly	monstruosamente
freak	monstruo
freaks	monstruos
freed	liberado
freedom	libertad
freedoms	libertades
free	gratis
freeze	congelar
freezing	congelación
frenetically	frenéticamente
frenetic	frenético
frenzied	frenético
frenzy	frenesí
fresh	fresco
fretful	irritable
frets	trastes
fret	traste
friction	fricción
frictions	fricciones
fried	frito
friendliness	amabilidad
friendly	amistoso
friggin	puto
frighten	asustar
frightening	aterrador
frighteningly	pavorosamente
frightful	espantoso
frightfully	espantosamente
fright	susto
frigid	frígido
frolic	fiesta
frost	helada
frown	ceño
froze	congeló
frozen	congelado
fruitful	fructífero
fruitless	infructuoso
fruitlessly	infructuosamente
frustrated	frustrado
frustrate	frustrar
frustrates	frustra
frustrating	frustrante
frustratingly	frustrante
frustration	frustración
frustrations	frustraciones
fucking	jodido
fuck	joder
fugitive	fugitivo
fulfillment	cumplimiento
fulminate	fulminar
fume	humo
fumes	humo
fundamentalism	fundamentalismo
fun	diversión
funky	miedoso
funnily	cómicamente
funny	divertido
furious	furioso
furiously	furiosamente
fury	furia
fuss	bulla
fussy	quisquilloso
fustigate	fustigar
fusty	mohoso
futile	fútil
futilely	inútilmente
futility	futilidad
futuristic	futurista
fuzzy	borroso
gabble	parloteo
gaffe	patinazo
gaff	garfio
gaiety	alegría
gaily	alegremente
gained	ganado
gainfully	remunerado
gainful	remunerativo
gain	ganancia
gaining	negociación
gainsay	contradecir
gains	prima
gallant	galante
gallantly	gallardamente
gall	hiel
galling	mortificante
galls	agallas
gangster	gángster
garbage	basura
garish	llamativo
gasp	grito
gauche	desmañado
gaudy	llamativo
gawky	desgarbado
geeky	geek
geezer	vejestorio
gem	joya
gems	gemas
generosity	generosidad
generous	generoso
generously	generosamente
genius	genio
genocide	genocidio
gentle	suave
genuine	genuino
ghastly	horrible
ghetto	gueto
gibber	farfullar
gibberish	algarabía
gibe	burla
giddy	mareado
gifted	dotado
gimmicked	trucada
gimmicks	trucos
gimmick	truco
gimmicky	efectista
glad	contento
gladden	alegrar
gladness	alegría
glamorous	atractivo
glare	deslumbramiento
glaringly	deslumbrante
gleeful	jubiloso
gleefully	alegremente
glee	júbilo
glib	elocuente
glimmering	resplandeciente
glistening	brillante
glisten	relucir
glitter	purpurina
glitz	brillo
gloom	penumbra
gloomy	triste
glorify	glorificar
glorious	glorioso
gloriously	gloriosamente
glory	gloria
glow	brillar
glowing	brillante
glowingly	elogiosamente
glum	sombrío
glut	superabundancia
gnawing	roer
goad	aguijón
god-awful	espantoso
godlike	divino
godsend	bendición
golden	dorado
gold	oro
good	bueno
good	buena
good	buenos
good	buenas
good	well
goodly	hermoso
goodness	bondad
goof	bobo
goofy	mentecato
goon	matón
gorgeously	magníficamente
gorgeous	maravilloso
gossip	chismes
graceful	agraciado
gracefully	graciosamente
grace	gracia
gracious	gracioso
graciously	graciosamente
graciousness	gracia
graft	injerto
grainy	granoso
grandeur	grandeza
grand	magnífico
grapple	luchar
grateful	agradecido
grate	reja
gratification	gratificación
gratified	gratificado
gratifies	gratifica
gratifying	gratificante
gratifyingly	gratificantemente
gratify	satisfacer
grating	rejilla
gratitude	agradecimiento
gravely	gravemente
greasy	grasiento
greatest	mayor
great	gran
greatness	grandeza
greed	codicia
greedy	codicioso
grief	dolor
grievance	queja
grievances	quejas
grieve	afligirse
grieving	duelo
grievous	grave
grievously	gravemente
grimace	mueca
grim	severo
grind	moler
grin	sonrisa
gripe	queja
gripes	cólicos
grisly	espeluznante
gritty	arenoso
gross	bruto
grossly	gravemente
grotesque	grotesco
grouch	gruñón
grouchy	malhumorado
groundbreaking	innovador
groundless	infundado
grouse	queja
growl	gruñido
grudge	rencor
grudges	rencores
grudging	avaro
gruesome	horrible
gruesomely	horriblemente
gruff	brusco
grumble	queja
grumpier	gruñón
grumpily	gruñonamente
grumpy	gruñón
guarantee	garantía
guidance	dirección
guile	engaño
guilt	culpa
guiltily	culpablemente
guiltless	inocente
guilty	culpable
gullible	crédulo
gumption	agallas
gush	chorro
gusto	entusiasmo
gutsy	valiente
gutter	canalón
hack	corte
haggard	ojeroso
haggle	regatear
hail	granizo
hale	sano
hallmark	contraste
hallmarks	características
hallowed	santificado
hallucinate	alucinar
hallucination	alucinación
hampered	obstaculizado
hamper	estorbar
handicapped	discapacitados
handily	cómodamente
handsome	guapo
handsomely	generosamente
handy	práctico
hang	caída
hangs	cuelga
hapless	desventurado
happily	felizmente
happiness	felicidad
happy	feliz
harangue	arenga
harass	acosar
harassed	acosado
harasses	acose
harassment	acoso
harbors	puertos
hardball	béisbol
hard	duro
harden	duro
hardened	curtido
hardship	privación
hardships	dificultades
hard-working	trabajador
hardy	resistente
harm	daño
harmed	perjudicado
harmful	perjudicial
harmless	inofensivo
harmonious	armonioso
harmoniously	armoniosamente
harmonize	armonizar
harmony	armonía
harpy	arpía
harridan	bruja
harrow	grada
harsh	áspero
harshly	duramente
hassle	molestia
hassles	molestias
haste	prisa
hastily	precipitadamente
hasty	apresurado
hated	odiado
hatefully	odio
hatefulness	odiosidad
hateful	odioso
hate	odio
haters	enemigos
hates	odios
hating	odiando
hatred	odio
haughtily	altivamente
haughty	altivo
haunting	obsesionante
haunt	rondar
havoc	estragos
haywire	loco
hazardous	peligroso
hazard	peligro
haze	neblina
hazy	brumoso
headway	progreso
heal	sanar
healthful	sano
healthy	saludable
heartbreaker	rompecorazones
heartbreaking	angustioso
heartbreakingly	desgarradoramente
hearten	corazón
heartening	alentador
heartfelt	cordial
heartily	sinceramente
heartless	insensible
heartwarming	reconfortante
heathen	pagano
heaven	cielo
heavenly	celestial
heck	infierno
hectic	frenético
hedge	cobertura
hedonistic	hedonista
heedless	desatento
hefty	fuerte
hegemonism	hegemonismo
hegemonistic	hegemonística
hegemony	hegemonía
heinous	atroz
hell-bent	empeñado
hell	infierno
hells	infiernos
helped	ayudado
helpful	útil
helping	ayudar
helpless	impotente
helplessness	impotencia
heresy	herejía
heretical	herético
heretic	hereje
hero	héroe
heroically	heroicamente
heroic	heroico
heroine	heroína
hesitant	vacilante
hideous	horrible
hideously	horriblemente
hideousness	fealdad
hilarious	hilarante
hinder	dificultar
hindrance	obstáculo
hissed	siseado
hissing	silbido
hiss	silbido
hoard	acumulación
hoax	engaño
hobble	cojera
hogs	cerdos
ho-hum	aburrida
hollow	hueco
holy	santo
homage	homenaje
honest	honesto
honesty	honestidad
honored	honrado
honoring	homenaje
hoodwink	engañar
hooligan	gamberro
hooray	hurra
hopeful	esperanzado
hopelessness	desesperación
horde	horda
horrendous	horrendo
horrendously	horrendamente
horrific	horrendo
horrified	horrorizado
horrifies	horroriza
horrify	horrorizar
horrifying	horripilante
hospitable	hospitalario
hostage	rehén
hostile	hostil
hostilities	hostilidades
hostility	hostilidad
hotbeds	semilleros
hot	caliente
hotheaded	exaltado
hothead	exaltado
hothouse	invernáculo
huckster	mercachifle
hug	abrazo
humane	humano
humble	humilde
humid	húmedo
humiliate	humillar
humiliating	humillante
humiliation	humillación
humility	humildad
humming	zumbador
humorous	humor
humour	humor
humourous	chistoso
hum	zumbido
hurt	daño
hurtful	hiriente
hurting	lastimar
hustler	estafador
hype	bombo
hypocricy	hipocresía
hypocrisy	hipocresía
hypocrite	hipócrita
hypocrites	hipócritas
hypocritical	hipócrita
hypocritically	hipócritamente
hysteria	histeria
hysterical	histérico
hysterically	histéricamente
hysteric	histérico
hysterics	histerismo
idealize	idealizar
ideally	idealmente
idiocies	idioteces
idiocy	idiotez
idiotically	idiota
idiotic	idiota
idiot	idiota
idiots	idiotas
idle	ocioso
idol	ídolo
idolized	idolatrado
idolize	idolatrar
idyllic	idílico
ignoble	innoble
ignominious	ignominioso
ignominiously	ignominiosamente
ignominy	ignominia
ignorance	ignorancia
ignorant	ignorante
ill-advised	desaconsejado
illegal	ilegal
illegally	ilegalmente
illegitimate	ilegítimo
ill-fated	malogrado
ill-favored	feo
illicit	ilícito
illiterate	analfabeto
ill-mannered	maleducado
ill-natured	malévolo
illness	enfermedad
illogical	ilógico
illogically	ilógicamente
illuminate	iluminar
illuminating	iluminador
illumine	iluminar
illusion	espejismo
illusions	ilusiones
illusory	ilusorio
illustrious	ilustre
imaculate	impecable
imaginary	imaginario
imaginative	imaginativo
imbalance	desequilibrio
imbecile	imbécil
imbroglio	embrollo
immaculate	inmaculado
immaculately	inmaculadamente
immaterial	inmaterial
immature	inmaduro
immense	inmenso
imminence	inminencia
imminently	inminentemente
immobilized	inmovilizado
immoderate	inmoderado
immoderately	inmoderadamente
immodest	inmodesto
immoral	inmoral
immorality	inmoralidad
immorally	inmoralmente
immovable	inamovible
impaired	deterioro
impair	perjudicar
impartial	imparcial
impartiality	imparcialidad
impartially	imparcialmente
impassioned	apasionado
impatience	impaciencia
impatient	impaciente
impatiently	impacientemente
impeach	procesar
impeccable	impecable
impeccably	impecablemente
impedance	impedancia
impede	impedir
impediment	impedimenta
impending	inminente
impenitent	impenitente
imperfect	imperfecto
imperfection	imperfección
imperfectly	imperfectamente
imperious	imperioso
imperiously	imperiosamente
impermissible	inadmisible
impertinent	impertinente
impetuous	impetuoso
impetuously	impetuosamente
impiety	impiedad
impinge	invadir
impious	impío
implausible	increíble
implausibly	inverosímilmente
implicate	implicar
implication	implicación
implode	implosionar
impolite	descortés
impolitic	impolítico
important	importante
importunate	importuno
importune	importunar
impose	prescribir
imposing	colonial
imposition	imposición
impossible	imposible
impossibly	imposiblemente
impotent	impotente
impoverished	empobrecido
impoverish	empobrecer
imprecate	imprecar
imprecise	impreciso
imprecisely	imprecisa
imprecision	imprecisión
impressed	impresionado
impresses	impresiona
impress	impresionar
impressive	impresionante
impressively	impresionantemente
imprison	aprisionar
imprisonment	encarcelamiento
improbability	improbabilidad
improbably	improbablemente
improper	impropio
improperly	indebidamente
impropriety	impropiedad
improved	mejorado
improve	mejorar
improvement	mejora
improvements	mejoras
improves	mejora
improving	mejorar
imprudence	imprudencia
imprudent	imprudente
impudence	impudencia
impudent	impudente
impudently	impudentemente
impugn	impugnar
impulsive	impulsivo
impulsively	impulsivamente
impunity	impunidad
impure	impuro
impurity	impureza
inability	incapacidad
inaccuracies	inexactitudes
inaccuracy	inexactitud
inaccurate	inexacto
inaccurately	inexactamente
inaction	inacción
inactive	inactivo
inadequacy	insuficiencia
inadequate	insuficiente
inadequately	inadecuadamente
inadvisable	desaconsejable
inanely	estúpidamente
inappropriate	inapropiado
inappropriately	inapropiadamente
inapt	inepto
inaptitude	ineptitud
inarticulate	inarticulado
inattentive	inatento
incapable	incapaz
incautious	incauto
incendiary	incendiario
incense	incienso
incessant	incesante
incessantly	incesantemente
incite	incitar
incitement	incitación
incivility	incivilidad
inclement	inclemente
incognizant	ignorante
incoherence	incoherencia
incoherent	incoherente
incoherently	incoherentemente
incommensurate	inconmensurable
incomparably	incomparablemente
incompatability	incompatibilidad
incompatibility	incompatibilidad
incompetence	incompetencia
incompetent	incompetente
incompetently	incompetente
incomplete	incompleto
incomprehensible	incomprensible
incomprehension	incomprensión
inconceivably	inconcebiblemente
incongruous	incongruente
incongruously	incongruentemente
inconsequential	inconsecuente
inconsequent	inconsecuente
inconsequently	inconsecuentemente
inconsiderate	desconsiderado
inconsiderately	desconsideradamente
inconsistencies	inconsistencias
inconsistency	inconsecuencia
inconsistent	inconsistente
inconsolably	inconsolablemente
inconstant	inconstante
inconvenience	inconveniencia
inconveniently	inconvenientemente
incorrect	incorrecto
incorrectly	incorrectamente
incorrigible	incorregible
incorrigibly	incorregible
incredible	increíble
incredibly	increíblemente
incredulous	incrédulo
incredulously	incredulidad
inculcate	inculcar
indebted	endeudado
indecency	indecencia
indecent	indecente
indecently	indecentemente
indecision	indecisión
indecisive	indeciso
indecisively	indeciso
indecorum	indecoro
indefensible	indefendible
indeterminate	indeterminado
indifference	indiferencia
indifferent	indifférent
indigent	indigente
indignant	indignado
indignation	indignación
indignity	indignidad
indiscreet	indiscreto
indiscreetly	indiscretamente
indiscretion	indiscreción
indiscriminate	indistinto
indiscriminately	indiscriminadamente
indiscriminating	indiscriminada
indistinguishable	indistinguible
individualized	individualizados
indoctrinate	adoctrinar
indoctrination	adoctrinamiento
indolent	indolente
indulge	complacer
indulgence	indulgencia
indulgent	indulgente
industrious	industrioso
ineffective	ineficaz
ineffectively	ineficazmente
ineffectiveness	inoperancia
ineffectual	ineficaz
ineffectually	ineficazmente
ineffectualness	ineficacia
inefficacious	ineficaz
inefficacy	ineficacia
inefficiency	ineficacia
inefficient	ineficiente
inefficiently	ineficientemente
ineligible	inelegible
inept	inepto
ineptitude	ineptitud
ineptly	ineptitud
inequality	desigualdad
inequitably	inequitativamente
inequities	desigualdades
inescapable	inevitable
inescapably	ineludiblemente
inestimably	inestimablemente
inevitably	inevitablemente
inexcusably	inexcusablemente
inexorably	inexorablemente
inexpensive	barato
inexperienced	despistados
inexperience	inexperiencia
inexpert	inexperto
inexpertly	inexpertamente
inextricably	inextricablemente
infallibility	infalibilidad
infallible	infalible
infallibly	infaliblemente
infamous	infame
infamously	infamemente
infamy	infamia
infected	infectado
infection	infección
infections	infecciones
inferiority	inferioridad
infested	infestada
infest	infestar
infidel	infiel
infidels	infieles
infiltrator	infiltrado
infiltrators	infiltrados
infirm	enfermizo
inflame	inflamar
inflammation	inflamación
inflammatory	inflamatorio
inflammed	inflamado
inflated	inflado
inflationary	inflacionista
inflict	infligir
influential	influyente
infraction	infracción
infringe	infringir
infringement	infracción
infringements	infracciones
infuriated	enfurecido
infuriate	enfurecer
infuriating	exasperante
infuriatingly	exasperantemente
ingenious	ingenioso
ingeniously	ingeniosamente
ingenuity	ingenio
ingenuous	ingenuo
ingenuously	ingenuamente
inglorious	ignominioso
ingratitude	ingratitud
inhibit	inhibir
inhibition	inhibición
inhospitable	hostil
inhumane	inhumano
inhuman	inhumano
inhumanity	inhumanidad
inimical	hostil
inimically	hostilmente
iniquitous	inicuo
iniquity	iniquidad
injure	lesionar
injurious	perjudicial
injury	lesión
injustice	injusticia
injustices	injusticia
innocuous	inocuo
innovation	innovación
innovative	innovador
innuendo	insinuación
inopportune	inoportuno
inordinate	desordenado
inordinately	desmesuradamente
insane	demente
insanely	locamente
insanity	locura
insatiable	insaciable
insecure	inseguro
insecurity	inseguridad
insensitive	insensible
insensitively	insensiblemente
insensitivity	insensibilidad
insidious	insidioso
insidiously	insidiosamente
insightfully	perspicacia
insightful	perspicaz
insignificance	insignificancia
insignificant	insignificante
insignificantly	insignificantemente
insincere	insincero
insincerely	insinceramente
insincerity	insinceridad
insinuate	insinuar
insinuating	insinuante
insinuation	insinuación
insolence	insolencia
insolent	insolente
insolently	insolentemente
insolvent	insolvente
insouciance	despreocupación
inspirational	inspirado
inspiration	inspiración
inspiring	inspirador
instability	inestabilidad
instable	inestable
instantly	instantáneamente
instigate	instigar
instigator	instigador
instigators	instigadores
instructive	instructivo
insubordinate	insubordinado
insubstantial	insubstancial
insubstantially	insustancial
insufferable	insufrible
insufferably	insufriblemente
insufficiency	insuficiencia
insufficient	insuficiente
insufficiently	insuficientemente
insulted	insultado
insulting	insultante
insultingly	insultantemente
insult	insulto
insults	insultos
insupportable	insoportable
insupportably	insoportablemente
insurmountable	insuperable
insurmountably	insuperablemente
insurrection	insurrección
integral	exhaustivo
integrated	integrado
intelligence	inteligencia
intelligent	inteligente
intelligible	inteligible
intense	intenso
interesting	interesante
interests	intereses
interfere	interferir
interference	interferencia
interferes	interfiere
intermittent	intermitente
interrupt	interrumpir
interruption	interrupción
interruptions	interrupciones
intimacy	intimidad
intimate	íntimo
intimidate	intimidar
intimidating	intimidante
intimidatingly	intimidantemente
intimidation	intimidación
intolerance	intolerancia
intoxicate	intoxicar
intractable	intratable
intransigence	intransigencia
intransigent	intransigente
intricate	intrincado
intrigue	intriga
intriguingly	curiosamente
intriguing	secreto
intrude	entrometerse
intrusion	intrusión
intrusive	intruso
intuitive	intuitivo
inundated	inundados
inundate	inundar
invader	invasor
invalidate	invalidar
invalid	inválido
invalidity	invalidez
invaluable	inestimable
invasive	invasor
invective	invectiva
inveigle	seducir
inventive	inventivo
invidious	injusto
invidiously	envidiosamente
invigorate	vigorizar
invigorating	vigorizante
invincibility	invencibilidad
invincible	invencible
inviolate	inviolado
involuntarily	involuntariamente
involuntary	involuntario
irate	airado
irately	airadamente
ire	ira
irked	irritado
irk	fastidiar
irksome	molesto
irksomeness	fastidio
ironical	irónico
ironically	irónicamente
ironic	irónico
ironies	ironías
irony	ironía
irrational	irracional
irrationalities	irracionalidades
irrationality	irracionalidad
irrationally	irracionalmente
irrationals	irracionales
irreconcilable	irreconciliable
irrecoverable	irrecuperable
irrecoverably	irrecuperable
irredeemable	irredimible
irregularity	irregularidad
irrelevance	irrelevancia
irrelevant	irrelevante
irreplaceable	irremplazable
irrepressible	irreprimible
irreproachable	irreprochable
irresistibly	irresistiblemente
irresolute	irresoluto
irresolvable	irresoluble
irresponsible	impulsivo
irresponsibly	irresponsable
irretrievable	irreparable
irritably	irritado
irritant	irritante
irritated	irritado
irritate	irritación
irritating	irritante
irritation	irritación
irritations	irritaciones
isolate	aislar
isolated	aislado
isolation	aislamiento
issue	cuestión
issues	cuestiones
itching	prurito
itch	prurito
itchy	picante
jabber	farfullar
jaded	hastiado
jagged	dentado
jam	mermelada
jarring	discorde
jaundiced	ictérico
jaw-droping	asombroso
jaw-dropping	asombroso
jealous	celoso
jealously	celosamente
jealousy	celos
jeer	burla
jeering	burlas
jeeringly	burlonamente
jeers	burlas
jeopardy	peligro
jerk	tirón
jerky	espasmódico
jitters	nervios
jittery	nervioso
job-killing	trabajo-matanza
joke	broma
joker	comodín
jollify	alegrar
jolly	alegre
jolt	sacudida
joy	alegría
joyful	alegre
joyfully	alegremente
joyous	jubiloso
joyously	gozosamente
jubilant	jubiloso
jubilantly	jubilosamente
jubilate	jubilar
jubilation	jubilación
judders	vibra
judder	vibración
judicious	juicioso
jumpy	asustadizo
junk	basura
junky	adicto
justly	justamente
keen	humos
keenly	agudamente
keenness	agudeza
killed	matado
killer	asesino
killing	matanza
killjoy	aguafiestas
kill	matar
kills	muertes
kindliness	bondad
kindly	amablemente
kindness	bondad
knave	sota
knife	cuchillo
knock	llamar
knotted	anudado
knowledgeable	experto
kooky	excéntrica
kudos	prestigio
lackadaisical	lánguido
lacked	carecido
lackey	lacayo
lackeys	lacayos
lack	falta
lacking	carente
lackluster	deslucido
lacks	carece
laconic	lacónico
lagged	lag
lagging	retraso
laggy	lag
lag	retraso
lags	desfases
laid-off	despedidos
lame	cojo
lame-duck	saliente
lamentably	lamentablemente
lament	lamento
languid	lánguido
languish	languidecer
languor	languidez
languorous	lánguido
languorously	langurosamente
lanky	larguirucho
lapsed	caducado
lapse	lapso
lapses	lapsos
lascivious	lascivo
laudable	loable
laudably	laudablemente
laud	alabar
laughable	cómico
laughingstock	hazmerreír
lavishly	profusamente
lavish	pródigo
lawbreaker	transgresor
lawful	legal
lawfully	legalmente
lawless	ilegal
lawlessness	desorden
layoff	despido
lazy	perezoso
lead	conducir
leading	líder
leads	plomos
leakage	fuga
leakages	fugas
leak	fuga
leaking	fugas
leaks	fugas
leaky	agujereado
lean	magro
lecherous	lascivo
lechery	lascivia
leech	sanguijuela
leery	sospechoso
legendary	legendario
lemon	limón
lengthy	largo
lethal	letal
lethargic	letárgico
lethargy	letargo
leverage	apalancamiento
levity	ligereza
lewd	lascivo
lewdly	lascivamente
lewdness	lascivia
liability	responsabilidad
liable	responsable
liar	mentiroso
liars	mentirosos
liberate	liberar
liberation	liberación
liberty	libertad
licentious	licencioso
licentiously	licenciosamente
licentiousness	libertinaje
lied	mentido
lie	mentira
lies	mentiras
lifesaver	salvavidas
lighter	encendedor
light-hearted	alegre
likable	agradable
likes	gustos
liking	gusto
limitation	limitación
limitations	limitaciones
limited	limitado
limit	límite
limits	límites
limp	cojear
lionhearted	valiente
listless	apático
litigious	litigioso
lively	animado
livid	lívido
lividly	lívidamente
loathe	detestar
loathing	aborrecimiento
loathsomely	repugnantemente
loathsome	repugnante
logical	lógico
loneliness	soledad
lonely	solitario
loner	solitario
lone	solitario
lonesome	solitario
longing	anhelo
longingly	añoranza
long-winded	prolijo
loophole	escapatoria
loopholes	lagunas
loose	suelto
loot	botín
lose	perder
loser	perdedor
losers	perdedores
loses	pierde
losing	perder
losses	pérdidas
loss	pérdida
lost	perdido
loud	ruidoso
lousy	piojoso
lovable	amable
love	amor
loved	amado
loveliness	hermosura
lovely	precioso
lover	amante
loves	ama
loving	amoroso
lowly	humilde
loyal	leal
loyalty	lealtad
lucid	lúcido
lucidly	lúcidamente
luckier	suerte
luck	suerte
lucky	afortunado
lucrative	lucrativo
ludicrously	ridículamente
ludicrous	ridículo
lugubrious	lúgubre
lukewarm	tibio
lull	calma
luminous	luminoso
lumpy	grumoso
lunatic	lunático
lurch	estacada
lure	señuelo
lurid	espeluznante
lurking	acecho
lush	exuberante
luster	lustre
lustrous	lustroso
luxuriant	exuberante
luxuriate	deleitarse
luxurious	lujoso
luxuriously	lujosamente
luxury	lujo
lying	acostado
lyrical	lírico
macabre	macabro
madden	enloquecer
maddening	enloquecedor
maddeningly	exasperantemente
madder	rubia
mad	loco
madly	locamente
madman	loco
madness	locura
magical	mágico
magic	magia
magnanimously	magnánimamente
magnanimous	magnánimo
magnificence	magnificencia
magnificently	magníficamente
magnificent	magnífico
majestic	majestuoso
majesty	majestad
maladjusted	inadaptado
maladjustment	inadaptación
malady	enfermedad
malaise	malestar
malcontent	malcontento
malevolence	malevolencia
malevolent	malévolo
malice	malicia
maliciously	maliciosamente
malicious	malicioso
maliciousness	malicia
malignant	maligno
malign	maligno
malodorous	maloliente
manageable	manejable
maneuverable	maniobrable
mangled	mutilado
mangle	exprimidor
maniacal	maníaco
maniac	maníaco
mania	manía
manic	maníaco
manipulate	manipular
manipulation	manipulación
manipulative	manipulativo
manipulators	manipuladores
marginally	ligeramente
martyrdom	martirio
marveled	maravillado
marvelled	maravillado
marvellous	maravilloso
marvel	maravilla
marvelously	maravillosamente
marvelous	maravilloso
marvels	maravillas
mashed	puré
massacre	matanza
massacres	masacres
masterfully	magistralmente
masterful	maestro
master	maestro
mastery	maestría
matchless	incomparable
matte	mate
mature	maduro
maturity	madurez
mawkish	empalagoso
mawkishness	sensiblería
meager	exiguo
meaningful	significativo
meanness	mezquindad
measly	miserable
meddle	entrometerse
meddlesome	entrometido
mediocrity	mediocridad
melancholy	melancolía
melodramatically	melodramáticamente
melodramatic	melodramático
meltdown	crisis
menace	amenaza
menacing	amenazador
mendacious	mendaz
mendacity	mendacidad
menial	servil
mercifully	piadosamente
merciful	misericordioso
merciless	despiadado
mercy	misericordia
merit	mérito
meritorious	meritorio
merrily	alegremente
merriment	alegría
merriness	alegría
merry	alegre
mesmerized	hipnotizado
mesmerize	hipnotizar
mesmerizes	hipnotiza
mesmerizing	fascinante
messes	líos
messing	ensuciando
mess	lío
messy	confuso
meticulously	meticulosamente
meticulous	meticuloso
midget	enano
miff	disgustar
mightily	poderosamente
mighty	poderoso
militancy	militancia
mind-blowing	alucinante
miracle	milagro
miracles	milagros
miraculous	asombroso
miraculously	milagrosamente
mirage	espejismo
mire	fango
misalign	desalinear
misaligned	desalineada
misaligns	desalinea
misbegotten	bastardo
miscellaneous	diverso
mischief	travesura
mischievously	maliciosamente
mischievous	travieso
miscreant	bellaco
miscreants	malhechores
miserable	desgraciado
miserably	tristemente
miser	avaro
miseries	miserias
miserly	avaro
misery	miseria
misfit	inadaptado
misfortune	desgracia
misgiving	recelo
misgivings	recelos
misguidance	extravío
misguided	equivocado
mishap	percance
mislead	engañar
misleading	engañoso
misleadingly	engañosamente
misrepresentation	falsificación
misrepresent	falsificar
missed	perdido
misses	pierde
miss	señorita
mistake	error
mistaken	equivocado
mistakenly	erróneamente
mistakes	errores
mist	niebla
mistress	amante
mistrust	desconfianza
mistrustful	desconfiado
mistrustfully	desconfianza
mists	nieblas
misunderstanding	malentendido
misunderstandings	malentendidos
misunderstood	malinterpretado
moan	gemido
mobster	gángster
mocked	burlado
mockeries	burlas
mockery	burlas
mocking	burlón
mockingly	burlonamente
mocks	burla
mock	simulado
modern	moderno
modest	modesto
modesty	modestia
molestation	acoso
molest	molestar
momentous	trascendental
monotonous	monótono
monotony	monotonía
monster	monstruo
monstrosities	monstruosidades
monstrosity	monstruosidad
monstrously	monstruosamente
monstrous	monstruoso
monumentally	monumentalmente
moot	discutible
mope	melancólico
morality	moralidad
morbidly	mórbida
morbid	mórbido
mordantly	mordazmente
mordant	mordaz
moribund	moribundo
moronic	imbécil
moron	idiota
morons	tarados
mortification	mortificación
mortified	mortificado
mortifying	mortificante
mortify	mortificar
motionless	inmóvil
motivated	motivado
motley	abigarrado
mourner	doliente
mournfully	tristemente
mournful	triste
mourn	llorar
muddle	embrollo
muddy	fangoso
mudslinging	vilipendio
mulish	terco
multi-polarization	multipolarización
multi-purpose	multiuso
mundane	mundano
murder	asesinato
murderer	asesino
murderous	asesino
murky	turbio
muscle-flexing	músculo-flexión
mushy	mollar
musty	mohoso
mysteriously	misteriosamente
mysterious	misterioso
mystery	misterio
mystify	mistificar
myth	mito
nagging	persistente
nag	rocín
naive	ingenuo
naïve	ingenuo
naively	ingenuamente
nastily	groseramente
nastiness	suciedad
nasty	repugnante
naughty	travieso
nauseate	repugnar
nauseates	náuseas
nauseatingly	asquerosamente
nauseating	nauseabundo
navigable	navegable
neatly	pulcramente
neat	ordenado
nebulously	vagamente
nebulous	nebuloso
need	necesitan
needed	necesitaba
needed	necesitaban
needless	innecesario
needlessly	innecesariamente
needs	necesita
needy	necesitado
nefariously	vilmente
nefarious	vil
negate	negar
negation	negación
negative	negativo
negatives	negativos
negativity	negatividad
neglected	descuidado
neglect	neglecta
negligence	negligencia
negligent	negligente
nemesis	justicia
nepotism	nepotismo
nervously	nerviosamente
nervous	nervioso
nervousness	nerviosismo
nettle	ortiga
nettlesome	irritante
neurotically	neuróticamente
neurotic	neurótico
nice	agradable
nicely	bien
nicest	mejor
nifty	elegante
niggle	queja
niggles	peros
nightmare	pesadilla
nimble	ágil
nobly	noble
noiseless	silencioso
noise	ruido
noises	ruidos
noisy	ruidoso
nonexistent	inexistente
nonsense	disparates
nosey	fisgón
notably	notablemente
noteworthy	notable
notoriously	notoriamente
notorious	notorio
nourishing	nutritiva
nourishment	alimento
nourish	nutrir
novelty	novedad
noxious	nocivo
nuisance	molestia
numb	entumecido
nurturing	crianza
obese	obeso
objectionable	objetable
objection	objeción
objections	objeciones
object	objeto
oblique	oblicuo
obliterated	obliterado
obliterate	obliterar
obnoxious	desagradable
obnoxiously	odiosamente
obscenely	obscenamente
obscene	obsceno
obscenity	obscenidad
obscured	oscurecido
obscure	oscuro
obscures	oscurece
obscurity	oscuridad
obsession	obsesión
obsessions	obsesiones
obsessively	obsesivamente
obsessiveness	obsesión
obsessive	obsesionante
obsess	obsesionar
obsolete	obsoleto
obstacle	obstáculo
obstinately	obstinadamente
obstinate	obstinado
obstructed	obstruido
obstructing	obstructivo
obstruction	obstrucción
obstruct	obstruir
obstructs	obstruye
obtainable	asequible
obtrusive	molesto
obtuse	obtuso
occluded	ocluido
occlude	ocluir
occludes	ocluye
occluding	oclusión
odd	impar
oddities	rarezas
oddity	rareza
oddly	extrañamente
odor	olor
offence	delito
offender	delincuente
offending	infractor
offend	ofender
offenses	delitos
offensively	ofensivamente
offensiveness	ofensivo
offensive	ofensiva
officious	oficioso
ominously	ominosamente
ominous	siniestro
omission	omisión
omit	omitir
onerously	onerosa
onerous	oneroso
one-sided	unilateral
onslaught	embate
openly	abiertamente
openness	franqueza
opinionated	dogmático
opponent	adversario
opportunistic	oportunista
opposition	oposición
oppositions	oposiciones
oppression	opresión
oppressively	opresivamente
oppressiveness	opresión
oppressive	opresivo
oppress	oprimir
oppressors	opresores
optimal	óptima
optimism	optimismo
optimistic	optimista
opulent	opulento
ordeal	ordalías
orderly	ordenado
originality	originalidad
orphan	huérfano
outbreak	brote
outburst	explosión
outbursts	arrebatos
outcast	marginado
outcry	grito
outdo	exceder
outdone	aventajado
outlaw	proscribir
outmoded	anticuado
outperformed	superado
outperforming	superando
outperforms	supera
outperform	superan
outrage	atropello
outraged	indignados
outrageous	indignante
outrageously	atrozmente
outrages	ultrajes
outshine	eclipsar
outshone	eclipsó
outsider	forastero
outsmart	burlar
outstandingly	sobresalientemente
outstanding	sobresaliente
outstrip	aventajar
outwit	burlar
ovation	ovación
over-acted	sobre-actuado
overacted	sobreactuado
overact	sobreactuar
over-balanced	sobre-equilibrada
overbalanced	sobrenivelado
overbearing	imperioso
overblown	marchito
overdo	exagerar
overdone	exagerado
overdue	atrasado
overemphasize	enfatizar
overheat	sobrecalentar
over-hyped	exageradas
overkill	exageración
overloaded	sobrecargado
overplay	exagerar
overpower	dominar
overpriced	caro
overrated	sobrevalorado
overreach	extralimitarse
overrun	invadir
overshadow	eclipsar
oversights	descuidos
oversight	vigilancia
oversimplification	sobresimplificación
oversimplified	simplificada
overstated	exagerado
overstate	exagerar
overstatement	exageración
overstatements	exageraciones
overstates	exagera
overtake	adelantar
overtaken	superado
overtakes	adelanta
overtaking	adelantamiento
overtaxed	sobrecargado
overthrow	derrocamiento
overthrows	derrocamientos
overtook	superó
overture	obertura
overturn	volcar
over-valuation	sobrevaloración
overweight	sobrepeso
overwhelm	abrumar
overwhelmed	abrumado
overwhelming	aplastante
overwhelmingly	abrumadoramente
overwhelms	abruma
pain	dolor
painful	doloroso
painfully	penosamente
pains	esfuerzos
palatial	palaciego
pale	pálido
pales	palidece
paltry	miserable
pamperedly	mimado
pampered	mimado
pamperedness	mimo
pamper	mimar
pampers	mima
pan	cacerola
pandemonium	pandemonio
pander	alcahuete
pandering	proxenetismo
panders	alcahuetes
panicked	pánico
panicking	pánico
panick	pánico
panic	pánico
panoramic	panorámico
paradise	paraíso
paradoxically	paradójicamente
paradoxical	paradójico
paralize	paralizar
paralyzed	paralizado
paramount	importantísimo
paranoid	paranoico
parasite	parásito
pardon	perdón
pariah	paria
parody	parodia
partiality	parcialidad
partisan	partidario
partisans	partidarios
passionate	apasionado
passionately	apasionadamente
passion	pasión
passiveness	pasividad
passive	pasivo
pathetically	patéticamente
pathetic	patético
patience	paciencia
patiently	pacientemente
patient	paciente
patriotic	patriótico
patriot	patriota
patronize	patrocinar
paucity	escasez
pauper	pobre
paupers	pobres
peaceable	pacífico
peaceful	pacífico
peace	paz
peach	melocotón
peculiarly	extrañamente
pedantic	pedante
peeled	pelado
peeved	furioso
peevish	malhumorado
penalize	penalizar
penalty	pena
pep	brillo
perfection	perfección
perfectly	perfectamente
perfect	perfecto
perfidious	pérfido
perfunctory	superficial
perilously	peligrosamente
perilous	peligroso
peril	peligro
perish	perecer
permissible	permisible
pernicious	pernicioso
perplexed	perplejo
perplexing	confuso
perplexity	perplejidad
persecute	perseguir
persecution	persecución
perseverance	perseverancia
persevere	perseverar
personages	personajes
personalized	personalizado
pertinaciously	pertinazmente
pertinacious	pertinaz
pertinacity	pertinacia
perturbed	perturbado
perturb	perturbar
pervasive	penetrante
perversely	perversamente
perverse	perverso
perversion	perversión
perversity	perversidad
perverted	pervertido
pervert	pervertido
perverts	pervertidos
pessimism	pesimismo
pessimistic	pesimista
pestilent	pernicioso
pest	parásito
petrified	petrificado
petrify	petrificar
petty	mezquino
phenomenal	fenomenal
phenomenally	fenomenalmente
phobia	fobia
phobic	fóbico
phony	falso
picketed	piquetes
picketing	piquetes
picket	piquete
pickets	piquetes
picky	exigente
picturesque	pintoresco
piety	piedad
pig	cerdo
pigs	cerdos
pillage	saqueo
pillory	picota
pimple	espinilla
pinch	pellizcar
pinnacle	pináculo
pique	piqué
pitiable	lamentable
pitiful	lamentable
pitifully	lastimosamente
pitiless	despiadado
pittance	miseria
pity	lástima
plagiarize	plagiar
plague	plaga
playful	juguetón
plaything	juguete
pleasant	agradable
pleasantly	agradablemente
pleased	satisfecho
pleases	plazca
pleasing	agradable
pleasingly	agradablemente
pleas	súplicas
plea	súplica
pleasurable	placentero
pleasurably	agradablemente
pleasure	placer
plebeian	plebeyo
plentiful	abundante
plight	situación
plot	parcela
ploy	táctica
plunderer	saqueador
plunder	saqueo
pluses	ventajas
plush	felpa
plusses	pros
poeticize	poetizar
poetic	poético
poignant	conmovedor
pointless	inútil
pointlessly	inútilmente
poised	listo
poise	porte
poisonously	venenosamente
poisonous	nocivo
poison	tóxico
pokey	diminuto
poky	diminuto
polarisation	polarización
polemize	polemizar
polished	pulido
polite	educado
politeness	cortesía
pollute	contaminar
polluter	contamina
polluters	contaminadores
polution	contaminación
pompous	pomposo
poorly	mal
poor	pobre
portable	portátil
posh	elegante
positively	afirmativamente
positive	positivo
positives	positivos
posturing	posturas
pout	abadejo
poverty	pobreza
powerfully	poderosamente
powerful	potente
powerless	impotente
praise	alabanza
praiseworthy	loable
praising	alabando
prate	prateek
prattle	parloteo
precariously	precariamente
precarious	precario
precious	precioso
precipitate	precipitar
precipitous	escarpado
precisely	precisamente
precise	preciso
predatory	depredador
predicament	predicamento
pre-eminent	preeminente
preeminent	preeminente
preferable	preferible
preferably	preferiblemente
prefered	preferida
prefer	preferir
preferring	prefiriendo
prefers	prefiere
prejudge	prejuzgar
prejudice	prejuicio
prejudices	prejuicios
prejudicial	perjudicial
premeditated	premeditado
preoccupy	preocupar
preposterous	absurdo
prestige	prestigio
prestigious	prestigioso
presumptuously	presuntuosamente
presumptuous	presuntuoso
pretence	pretensión
pretend	pretender
pretense	pretensión
pretentiously	pretenciosamente
pretentious	pretencioso
prettily	bonitamente
pretty	bastante
prevaricate	prevaricar
priceless	inestimable
pricey	caro
prickle	espina
prickles	espinas
prick	pinchazo
prideful	orgulloso
pride	orgullo
primitive	primitivo
prisoner	prisionero
prison	prisión
privileged	privilegiado
privilege	privilegio
prize	premio
proactive	proactivo
problematic	problemas
problem	problema
problems	problemas
procrastinate	aplazar
procrastinates	posterga
procrastination	dilación
prodigiously	prodigiosamente
prodigious	prodigioso
prodigy	prodigio
productively	productivamente
productive	productivo
profane	profano
profanity	blasfemia
proficient	competente
proficiently	soltura
profoundly	profundamente
profound	profundo
profuse	liberal
profusion	profusión
progressive	progresivo
progress	progreso
prohibitively	prohibitivamente
prohibitive	prohibitivo
prohibit	prohibir
prolific	prolífico
prominence	prominencia
prominent	prominente
promised	prometido
promise	promesa
promises	promesas
promising	propicio
promoter	promotor
prompt	rápido
proper	correcto
properly	correctamente
propitious	propicio
proprietary	propietario
prosecute	procesar
prosperity	prosperidad
prosperous	próspero
prosper	prosperar
protection	protección
protect	proteger
protested	protestado
protesting	protestar
protest	protesta
protests	protestas
protracted	prolongado
proud	orgulloso
proven	probado
proves	prueba
providence	providencia
proving	prueba
provocation	excitación
provocative	provocativo
provoke	provocar
prowess	proeza
prudence	prudencia
prudently	prudentemente
prudent	prudente
pry	palanca
pugnacious	pugnaz
pugnacity	pugnacidad
punch	ponche
punctual	puntual
punishable	castigable
punish	castigar
punitive	punitivo
puppet	marioneta
puppets	marionetas
pure	puro
purify	purificar
purposeful	útil
puzzled	perplejo
puzzlement	perplejidad
puzzling	misterioso
quack	charlatán
quaint	pintoresco
qualified	calificado
qualify	calificar
qualm	náusea
qualms	reparos
quandary	dilema
quarrel	pelea
quarrelsome	pendenciero
quarrels	peleas
quash	anular
queer	extraño
questionable	dudoso
quibbles	problemillas
quibble	sutileza
quiet	tranquilo
quitter	cobarde
rabid	rabioso
racism	racismo
racist	racista
racists	racistas
racy	picante
radiance	resplandor
radiant	radiante
radicalization	radicalización
radically	radicalmente
radicals	radicales
rage	rabia
ragged	harapiento
raging	rabioso
raked	rastrillado
rampage	alboroto
rampant	rampante
ramshackle	desvencijado
rancor	rencor
randomly	azar
rankle	doler
rant	despotricar
ranted	despotricó
ranting	desvaríos
rants	rantes
raped	violada
rape	violación
rapid	rápido
rapport	compenetración
rapt	absorto
rapture	rapto
rapturous	delirante
rascal	bribón
rascals	bribones
rash	erupción
rational	racional
rattled	sacudido
rattle	sonajero
rattles	sonajas
ravage	destrozar
raving	delirio
razor-sharp	afilada
reachable	alcanzable
reactionary	reaccionario
readable	legible
readily	fácilmente
ready	listo
reaffirmation	reafirmación
reaffirm	reafirmar
realistic	realista
reasonable	razonable
reasonably	razonablemente
reasoned	razonada
reassurance	seguridades
reassure	tranquilizar
rebellious	rebelde
rebuff	rechazo
rebuke	reprensión
recalcitrant	recalcitrante
recant	retractar
receptive	receptivo
recessionary	recesivo
recession	recesión
recklessly	imprudentemente
recklessness	imprudencia
reckless	temerario
reclaim	reclamar
recoil	retroceso
recomend	recomiendo
recommendation	recomendación
recommendations	recomendaciones
recommended	recomendado
recommend	recomendar
reconcile	reconciliar
reconciliation	reconciliación
record-setting	récord
recourses	recursos
recover	recuperar
recovery	recuperación
rectification	rectificación
rectifying	rectificación
rectify	rectificar
redeeming	redentor
redeem	redimir
redemption	redención
redundancy	redundancia
redundant	redundante
refined	refinado
refinement	refinamiento
refine	refinar
reformed	reformado
reforming	reformando
reform	reforma
reforms	reformas
refreshed	refrescado
refreshing	refrescante
refresh	refrescar
refunded	reintegrado
refund	reembolso
refusal	negativa
refused	rechazado
refuse	rechazar
refuses	niega
refusing	negándose
refutation	refutación
refuted	refutado
refute	refutar
refutes	refuta
refuting	refuta
regally	regiamente
regal	regio
regard	respecto
regression	regresión
regressive	regresivo
regress	retroceder
regretful	pesaroso
regret	lamentar
regrets	excusas
regrettable	lamentable
regrettably	lamentablemente
regretted	lamentar
rejected	rechazado
rejecting	rechazando
rejection	rechazo
reject	rechazar
rejects	rechaza
rejoice	alegrarse
rejoicing	alegría
rejuvenated	rejuvenecido
rejuvenate	rejuvenecer
rejuvenating	rejuvenecedor
relapse	recaída
relaxed	relajado
relent	ablandarse
relentless	implacable
relentlessly	implacablemente
relentlessness	implacabilidad
reliably	fiable
relief	alivio
relish	saborear
reluctance	renuencia
reluctant	reacio
remarkable	notable
remarkably	extraordinariamente
remedy	remedio
remission	remisión
remorseful	arrepentido
remorsefully	remordimiento
remorseless	implacable
remorselessness	implacabilidad
remorse	remordimiento
remunerate	remunerar
renaissance	renacimiento
renewed	renovado
renounce	renunciar
renowned	renombrado
renown	renombre
renunciation	renuncia
repel	repeler
repetitive	repetitivo
replaceable	reemplazable
reprehensible	censurable
reprehensibly	censurablemente
reprehension	reprensión
reprehensive	reprensibles
repression	repressió
repressive	represivo
repress	reprimir
reprimand	reprimenda
reproach	reproche
reprove	reprender
repudiate	repudiar
repudiation	repudio
repugnance	repugnancia
repugnantly	repugnantemente
repugnant	repugnante
repulsed	repelido
repulse	repulsión
repulsing	repeliendo
repulsiveness	repulsividad
repulsive	repulsivo
reputable	acreditado
reputation	reputación
resentful	resentido
resentment	resentimiento
resignation	renuncia
resigned	resignado
resilient	resistente
resistance	resistencia
resolute	resuelto
resounding	rotundo
resourceful	ingenioso
resourcefulness	inventiva
respectable	respetable
respectfully	respetuosamente
respectful	respetuoso
respect	respeto
respite	respiro
resplendent	resplandeciente
responsibly	responsable
responsive	sensible
restful	sosegado
restless	inquieto
restlessness	inquietud
restored	restaurada
restricted	restringido
restriction	restricción
restrictive	restrictivo
restrict	restringir
restructured	reestructurado
restructure	reestructurar
restructuring	reestructuración
resurgent	resurgente
retaliatory	vengativo
retarded	retardado
retard	retardar
retards	retardados
reticent	reticente
retractable	retráctil
retract	retraer
retreated	retirado
retreat	retiro
revelation	revelación
revengefully	vengativamente
revengeful	vengativo
revenge	venganza
reverence	reverencia
reverently	reverentemente
reverent	reverente
revere	reverenciar
revert	revertir
reviled	denostado
revile	injuriar
revitalize	revitalizar
revival	renacimiento
revive	reanimar
revives	revive
revoke	revocar
revolting	repugnante
revolt	revuelta
revolutionary	revolucionario
revolutionized	revolucionado
revolutionize	revolucionar
revolutionizes	revoluciona
revulsion	repugnancia
revulsive	revulsivo
rewardingly	recompensadoramente
rewarding	provechoso
reward	recompensa
rhapsodize	extasiarse
rhetorical	retórico
rhetoric	rhetorica
ricer	arrocera
richly	ricamente
richness	riqueza
rich	rico
ridicule	ridículo
ridicules	burlas
ridiculously	ridículamente
ridiculous	ridículo
rife	abundante
rift	grieta
rifts	divisiones
right	derecho
righten	derecho
righteous	justo
righteously	rectamente
righteousness	justicia
rightful	legítimo
rightfully	legítimamente
rightly	correctamente
rightness	justicia
rigidity	rigidez
rigidness	rigidez
rigid	rígido
rip-off	estafa
ripoff	estafa
ripped	rasgado
rip	rasgón
risk	riesgo
risks	riesgos
risky	arriesgado
rivalry	rivalidad
roadblocks	usted
robust	robusto
rocky	rocoso
rogue	pícaro
romantically	románticamente
romanticize	romantizar
romantic	romántico
roomy	espacioso
rosy	rosado
rot	podredumbre
rotten	podrido
rough	áspero
rubbish	basura
rude	grosero
rue	ruda
ruffian	rufián
ruffle	volante
ruined	arruinado
ruining	arruinando
ruinous	ruinoso
ruin	ruina
ruins	ruinas
rumbling	retumbante
rumple	arrugar
runaway	fugitivo
run-down	deteriorado
rupture	ruptura
rust	herrumbre
rusts	royas
rusty	oxidado
ruthless	implacable
ruthlessness	crueldad
rut	rodera
ruts	roderas
sabotage	sabotaje
sack	saco
sacrificed	sacrificado
sadden	entristecer
sadness	tristeza
sad	triste
safe	seguro
sagacity	sagacidad
sagely	sabiamente
sagged	combado
sagging	hundimiento
saggy	flaccidez
sag	hundimiento
saintliness	santidad
saintly	santo
saint	santo
salacious	salaz
salutary	saludable
salute	saludo
sanctimonious	mojigato
sane	cuerdo
sap	savia
sarcasm	sarcasmo
sarcastically	sarcásticamente
sarcastic	sarcástico
sardonically	sardónicamente
sardonic	sardónico
satirical	satírico
satirize	satirizar
satisfactorily	satisfactoriamente
satisfactory	satisfactorio
satisfied	satisfecho
satisfies	satisfecho
satisfying	satisfactorio
satisfy	satisfacer
savagery	salvajismo
savage	salvaje
savages	salvajes
saver	ahorrador
savings	ahorros
savior	salvador
savvy	comprensión
scaly	escamoso
scam	estafa
scams	estafas
scandal	escándalo
scandalized	escandalizado
scandalize	escandalizar
scandalous	escandaloso
scandalously	escandalosamente
scandals	escándalos
scant	escaso
scarce	escaso
scarcely	escasamente
scar	cicatriz
scarcity	escasez
scared	miedo
scare	susto
scarily	aterradoramente
scarred	cicatrizado
scars	cicatrices
scathingly	mordazmente
scathing	mordaz
scenic	escénico
sceptical	escéptico
scoff	burlarse
scoffingly	burlón
scolded	regañado
scolding	regaño
scold	regaño
scorching	abrasador
scorchingly	abrasadoramente
scorn	desdén
scornful	desdeñoso
scornfully	desdeñosamente
scoundrel	canalla
scourge	azote
scowl	ceño
scrambled	revuelto
scramble	lucha
scrambles	revuelve
scrambling	aleatorización
scrap	residuos
scratched	rayado
scratches	arañazos
scratch	rasguño
scratchy	chirriante
scream	grito
screech	chillido
screwed	roscado
screwed-up	atornillado-up
screw-up	tornillo-up
screwy	absurdo
scuff	arrastrar
scuffs	desgastes
scum	escoria
scummy	espumoso
seasoned	sazonado
secretive	reservado
secure	asegurar
securely	segura
sedentary	sedentario
seedy	sórdido
seethe	bullir
seething	hirviente
selective	selectivo
self-coup	autogolpe
self-criticism	autocrítica
self-defeating	contraproducente
self-destructive	autodestructivo
self-determination	autodeterminación
self-humiliation	auto-humillación
self-interested	egoísta
selfish	egoísta
selfishly	egoístamente
selfishness	egoísmo
self-respect	dignidad
self-serving	auto-servicio
self-sufficiency	autosuficiencia
self-sufficient	autosuficiente
semi-retarded	semi-retardado
senile	senil
sensationally	sensacionalmente
sensational	sensacional
sensation	sensación
sensations	sensaciones
sensible	sensato
sensitive	sensible
serene	sereno
serenity	serenidad
seriousness	seriedad
sermonize	sermonear
servitude	servidumbre
setback	revés
setbacks	contratiempos
sever	cortar
severe	grave
severity	severidad
sexy	atractivo
shabby	lamentable
shadowy	sombrío
shady	sombreado
shake	sacudir
shaky	tambaleante
shambles	ruinas
shamefully	vergonzosamente
shamefulness	vergüenza
shameful	vergonzoso
shameless	desvergonzado
shamelessly	desvergonzadamente
shamelessness	desvergüenza
shame	vergüenza
sham	impostor
shark	tiburón
sharp	afilado
sharply	bruscamente
shatter	destrozar
shemale	transexual
shimmer	brillo
shimmering	reluciente
shine	brillo
shiny	brillante
shipwreck	naufragio
shirk	eludir
shirker	gandul
shit	mierda
shiver	tiembla
shock	choque
shocked	conmocionado
shocking	chocante
shockingly	espantosamente
shoddy	pacotilla
shortage	escasez
shortcoming	defecto
shortcomings	deficiencias
short-lived	efímero
shortness	falta
shortsighted	miope
shortsightedness	miopía
showdown	confrontación
shrew	musaraña
shriek	chillido
shrill	estridente
shrilly	estridente
shrivel	encoger
shrouded	envuelto
shroud	mortaja
shunned	rechazado
shun	rehuir
sicken	enfermar
sick	enfermo
sickeningly	repugnantemente
sickening	nauseabundo
sickly	enfermizo
sickness	enfermedad
sidetrack	apartadero
sidetracked	desviarse
siege	cerco
significant	significativo
silent	silencioso
silly	tonto
simpler	sencillo
simplified	simplificado
simplifies	simplifica
simplifying	simplificando
simplify	simplificar
simplistically	simplista
simplistic	simplista
sincerely	sinceramente
sincere	sincero
sincerity	sinceridad
sinfully	pecaminosamente
sinful	pecaminoso
sinisterly	siniestramente
sinister	siniestro
sink	fregadero
sinking	hundimiento
sin	pecado
skeletons	esqueletos
skeptical	escéptico
skeptically	escepticismo
skeptic	escéptico
skepticism	escepticismo
sketchy	incompleto
skilled	entrenado
skillful	hábil
skillfully	hábilmente
skill	habilidad
skimpy	escaso
skinny	flaco
skittish	asustadizo
slack	flojo
slander	difamación
slanderer	calumniador
slanderous	calumnioso
slanderously	blasfemados
slanders	calumnias
slap	bofetada
slashing	roza
slaughtered	sacrificados
slaughter	masacre
slave	esclavo
slaves	esclavos
sleazy	sórdido
sleek	pulcro
slick	mancha
slime	limo
sloppily	descuidadamente
sloppy	descuidado
slothful	perezoso
sloth	pereza
slowed	ralentizado
slow	lento
slowly	despacio
slug	babosa
sluggish	lento
slump	depresión
slur	calumnia
slut	puta
sluts	zorras
sly	astuto
smack	golpe
smart	inteligente
smartly	inteligentemente
smear	frotis
smelled	olido
smelling	oliendo
smell	olor
smells	olores
smelly	maloliente
smelt	olido
smile	sonrisa
smiles	sonrisas
smilingly	sonriendo
smiling	sonriente
smitten	prendado
smoke	humo
smoldering	latente
smoothes	alisa
smooth	liso
smoothly	suavemente
smother	ahogar
smouldering	latente
smudged	manchado
smudge	mancha
smudges	manchas
smug	presumido
smut	tizón
smutty	tiznado
snagged	enganchado
snagging	enganches
snag	pega
snags	inconvenientes
snappish	brusco
snappishly	brusquedad
snappy	rápido
snare	lazo
snarl	gruñido
snazzy	elegante
sneak	furtivo
sneaky	furtivo
sneer	burla
sneering	despreciativos
sneeringly	burlonamente
snobbish	snob
snobby	snob
snub	desaire
soapy	jabonoso
sobering	aleccionadora
sober	sobrio
sob	sollozo
soft	suave
solace	solitud
solemn	solemne
solicitously	solícita
solicitous	solícito
solicitude	solicitud
solidarity	solidaridad
solid	sólido
somber	sombrío
soothe	calmar
sophisticated	sofisticado
sore	llaga
sorely	muy
soreness	dolor
sorrow	dolor
sorrowfully	tristemente
sorrowful	triste
sorry	triste
soulful	sentimental
soundly	sólidamente
soundness	solvencia
sour	agrio
sourly	acritud
spacious	espacioso
spade	pala
spank	azotar
sparkle	brillo
spectacular	espectacular
spectacularly	espectacularmente
speedily	rápidamente
speedy	veloz
spellbinding	fascinante
spellbound	hechizado
spendy	caro
spew	arrojar
spewed	vomitado
spewing	vomitando
spews	arroga
spilling	derramando
spinster	solterona
spirited	enérgico
spiritual	espiritual
spitefully	malévolamente
spiteful	malévolo
spitefulness	malevolencia
splatter	salpicadura
splendid	espléndido
splendidly	espléndidamente
splendor	esplendor
split	división
splitting	división
spoilage	deterioro
spoiled	estropeado
spoil	estropear
spoils	botín
spontaneous	natural
spook	espectro
spookier	fantasmagóricos
spooky	fantasmal
spoon-feed	mimar
sporadic	esporádico
sporty	deportivo
spotless	inmaculado
spotty	manchado
sprightly	animado
spurious	espurio
spurn	desdeñar
sputter	chisporroteo
squabble	disputa
squabbling	disputas
squander	tiempo
squash	calabacín
squeak	chirrido
squeaks	chirridos
squeaky	chirriante
squeal	chillido
squealing	chillido
squeals	chillidos
squirm	retorcerse
stability	estabilidad
stabilize	estabilizar
stable	estable
stab	puñalada
stagnant	estancado
stagnate	estancarse
stagnation	estancamiento
staid	serio
stainless	inoxidable
stain	mancha
stains	manchas
stalemate	estancamiento
stale	viciado
stall	establo
stalls	establos
stammer	balbuceo
stampede	estampida
standout	destacado
standstill	paralización
starkly	crudamente
stark	rígido
startle	asustar
startling	asombroso
startlingly	sorprendentemente
starvation	inanición
stately	majestuoso
state-of-the-art	puntera
static	estático
statuesque	estatuario
staunch	firme
staunchly	incondicionalmente
steadfast	firme
steadfastly	firmemente
steadfastness	firmeza
steadiness	firmeza
steady	firme
stealing	robo
steal	robar
steals	robos
steep	empinado
steeply	abruptamente
stellar	estelar
stench	hedor
stereotype	estereotipo
stereotypical	estereotipada
stereotypically	típico
stern	popa
stew	estofado
sticky	pegajoso
stiff	endurecer
stiffness	rigidez
stifle	ahogar
stiflingly	insoportablemente
stifling	sofocante
stigma	estigma
stigmatize	estigmatizar
stimulate	estimular
stimulates	estimula
stimulating	desafiante
stimulative	estimulante
stinging	escozor
sting	picadura
stingy	tacaño
stink	hedor
stinks	apesta
stodgy	pesado
stole	estola
stolen	robado
stooges	chiflados
stooge	secuaz
stormy	tempestuoso
straggle	rezagarse
straggler	rezagado
straighten	directamente
straightforward	sencillo
strained	tenso
straining	esfuerzo
strain	tensión
strange	extraño
strangely	extrañamente
stranger	desconocido
strangle	estrangular
streaky	entreverado
streamlined	aerodinámico
strenuous	agotador
stresses	tensiones
stress	estrés
stressful	estresante
stricken	afligido
strict	estricto
strictly	estrictamente
strident	estridente
stridently	estridentemente
strife	contienda
strike	huelga
striking	llamativo
strikingly	sorprendentemente
stringently	rigurosamente
stringent	riguroso
striving	esfuerzos
strong	fuerte
struggled	luchado
struggle	lucha
struggles	luchas
struggling	luchando
strut	puntal
stubbornly	tercamente
stubbornness	testarudez
stubborn	obstinado
stumbled	tropezado
stumbles	tropieza
stumble	tropezón
stumped	sacado
stump	muñón
stumps	tocones
stun	aturdir
stunned	aturdido
stunningly	sensacionalmente
stunning	maravilloso
stunted	enano
stunt	truco
stupendous	estupendo
stupendously	estupendamente
stupidest	estúpida
stupid	estúpido
stupidity	estupidez
stupidly	estúpidamente
stupor	estupor
sturdy	robusto
stuttered	tartamudeado
stuttering	tartamudeo
stutters	tartamudea
stutter	tartamudeo
stylish	elegante
stylishly	elegantemente
stylized	estilizado
stymied	obstaculizado
sty	pocilga
suave	afable
subdued	suave
subjected	sometido
subjection	sujeción
subjugate	subyugar
submissive	sumiso
subordinate	subordinado
subpoena	citación
subpoenas	citaciones
subservience	subordinación
subservient	subordinado
subsidized	subvencionado
subsidizes	subvenciona
subsidize	subvencionar
subsidizing	subvencionar
substandard	deficiente
substantive	sustantivo
subtract	sustraer
subversion	subversión
subversively	subversivamente
subversive	subversivo
subvert	subvertir
succeed	éxito
succes	éxito
successes	éxitos
success	éxito
successful	exitoso
succumb	sucumbir
suck	chupar
sucked	aspirado
sucker	ventosa
sucks	chupa
sue	demandar
suffered	sufrido
sufferers	enfermos
sufferer	víctima
suffering	sufrimiento
suffers	sufre
suffer	sufrir
suffice	baste
sufficed	bastado
suffices	suficiente
sufficiently	suficientemente
sufficient	suficiente
suffocate	sofocarse
sugar-coated	azucarado
sugar-coat	endulzar
suicidal	suicida
suicide	suicidio
suitable	adecuado
sullen	hosco
sully	manchar
sumptuously	suntuosamente
sumptuousness	suntuosidad
sumptuous	suntuoso
sunken	hundido
sunk	hundido
superbly	magníficamente
superb	magnífico
superficiality	superficialidad
superficially	superficialmente
superfluous	superfluo
superiority	superioridad
superstition	superstición
superstitious	supersticioso
super	súper
supple	flexible
support	apoyo
supported	apoyado
supporter	partidario
supporting	apoyando
supports	soportes
suppression	supresión
suppress	suprimir
supremacy	supremacía
supremely	supremamente
supreme	supremo
supurb	increíble
supurbly	increíblemente
surpass	superar
surreal	surrealista
surrender	rendición
survival	supervivencia
survivor	sobreviviente
susceptible	probablemente
suspect	sospechoso
suspicion	sospecha
suspicions	sospechas
suspicious	suspicaz
sustainability	sostenibilidad
sustainable	sostenible
swagger	contoneo
swamped	inundado
swank	presumir
swanky	ostentoso
sweaty	sudoroso
sweeping	general
sweet	dulce
sweeten	dulce
sweetheart	novio
sweetly	dulcemente
sweetness	dulzura
swelled	engrosado
swelling	hinchazón
swiftness	rapidez
swift	rápido
swindle	estafa
swollen	hinchado
symptom	síntoma
symptoms	síntomas
syndrome	síndrome
taboo	tabú
tacky	pegajoso
tainted	contaminado
taint	mancha
talents	talentos
talent	talento
tamper	antisabotaje
tangled	enredado
tangle	maraña
tangles	ovillos
tanked	tanqueado
tanks	tanques
tank	tanque
tantalize	atormentar
tantalizingly	tentadoramente
tantalizing	tentadora
tantrum	berrinche
tardy	tardío
tarnished	empañado
tarnish	empañar
tarnishes	empaña
tarnishing	deslustre
tattered	andrajoso
taunting	burlas
taunt	pulla
taunts	burlas
taut	tirante
tawdry	cursi
taxing	agotador
tease	embromar
tediously	tediosamente
tedious	tedioso
temerity	temeridad
temper	genio
tempest	tempestad
temptation	tentación
temptingly	tentadoramente
tempting	tentador
tempt	tentar
tenacious	tenaz
tenacity	tenacidad
tenderly	ternura
tenderness	dolor
tender	tierno
tense	tenso
tension	tensión
tentatively	tentativamente
tentative	tentativo
tenuously	tenuemente
tenuous	tenue
tepid	tibio
terribleness	terribilidad
terribly	terriblemente
terrifically	estupendamente
terrific	estupendo
terrorism	terrorismo
terrorize	aterrorizar
testy	irascible
tetchily	irasciblemente
tetchy	irritable
thank	agradecer
thankful	agradecido
thankless	ingrato
thinner	disolvente
thirst	sed
thorny	espinoso
thoughtfully	pensativamente
thoughtfulness	consideración
thoughtful	pensativo
thoughtless	irreflexivo
thoughtlessness	irreflexión
threat	amenaza
threaten	amenazar
threatening	amenazante
threats	amenazas
thrift	ahorro
thrifty	ahorrativo
thrilled	encantados
thrill	emoción
thrilling	electrizante
thrillingly	estremecedoramente
thrills	emociones
thrive	prosperar
thriving	próspera
throbbed	palpitaba
throbbing	palpitante
throb	latido
throbs	latidos
throttle	acelerador
thug	matón
thwart	frustrar
tickle	cosquillas
tidy	ordenado
time-honored	tradicional
timely	oportuno
timidity	timidez
timidly	timidez
timid	tímido
tingle	hormigueo
tingling	hormigueo
tin-y	estaño-y
tired	cansado
tiresome	cansado
tiring	fatigoso
titillate	excitar
titillating	excitante
togetherness	unión
toil	trabajo
toll	peaje
topple	derribar
top	superior
tormented	atormentado
torment	tormento
torrent	torrente
tortuous	tortuoso
tortured	torturado
tortures	torturas
torture	tortura
torturing	tortura
torturously	tortuosamente
torturous	tortuoso
totalitarian	totalitario
touchy	quisquilloso
tough	duro
toughness	tenacidad
touted	promocionado
tout	revendedor
touts	revendedores
toxic	tóxico
traction	tracción
traduce	difamar
tragedy	tragedia
tragically	trágicamente
tragic	trágico
traitorous	traidor
traitor	traidor
trample	pisotear
tramp	vagabundo
tranquility	tranquilidad
tranquil	tranquilo
transgression	transgresión
transgress	transgredir
transparent	transparente
traped	atrapado
trapped	atrapado
trap	trampa
trash	basura
trashed	destrozado
traumatically	traumáticamente
traumatic	traumático
traumatized	traumatizado
traumatize	traumatizar
travesty	parodia
treacherous	traicionero
treachery	traición
treason	traición
treasure	tesoro
tremendously	tremendamente
tricked	engañado
trickery	trampa
trick	truco
tricky	difícil
triumphal	triunfal
triumphantly	triunfantemente
triumphant	triunfal
triumph	triunfo
trivialize	trivializar
trivially	trivialmente
trophy	trofeo
troubled	turbulento
troublemaker	alborotador
trouble	problema
troublesome	molesto
troubles	problemas
troublingly	inquietantemente
troubling	preocupante
truant	ausente
trumpet	trompeta
trump	triunfo
trust	confianza
trusting	confianza
trustworthiness	integridad
trusty	fiel
truthfulness	veracidad
truthful	veraz
tumble	caer
tumbled	caído
tumbles	tumbos
tumultuous	tumultuoso
turbulent	turbulento
turmoil	confusión
twinkly	brillante
twisted	retorcido
twists	torceduras
twist	torcedura
two-faced	hipócrita
tyrannically	tiránicamente
tyrannical	tiránico
tyranny	tiranía
tyrant	tirano
ugh	uf
uglier	feo
ugliness	fealdad
ugly	feo
ultimatums	ultimátums
ultimatum	ultimátum
ultra-crisp	ultra-nítido
unabashed	desvergonzado
unable	incapaz
unacceptable	inaceptable
unacceptably	inaceptablemente
unachievable	inalcanzable
unaffected	inafectado
unaffordable	inasequible
unassailable	inatacable
unavailable	indisponible
unavoidably	inevitablemente
unbearable	inaguantable
unbeatable	insuperable
unbelievable	increíble
unbelievably	increíblemente
unbiased	imparcial
uncaring	indiferente
uncertain	incierto
uncivil	incivil
uncivilized	incivilizado
unclean	sucio
unclear	claro
uncollectible	incobrables
uncomfortable	incómodo
uncomfortably	incómodamente
uncomfy	incómoda
uncompromising	intransigente
unconditional	incondicional
unconstitutional	inconstitucional
uncooperative	incooperativo
uncouth	grosero
undaunted	impávido
undecided	indeciso
undefined	indefinido
undercut	socavada
undercuts	socavados
undercutting	subvaloración
underdog	desvalido
underestimate	subestimar
underlings	subordinados
undermined	minado
undermine	minar
undermines	socava
undermining	minando
undersized	insuficiente
understandable	comprensible
undesirable	indeseable
undetermined	indeterminado
undisputable	indiscutible
undisputably	indiscutiblemente
undisputed	indiscutible
undocumented	indocumentado
undone	deshecho
undue	indebido
unease	malestar
uneasily	inquieto
uneasiness	inquietud
uneasy	inquieto
uneconomical	antieconómico
unemployed	parados
unequal	desigual
unequivocal	inequívoco
unequivocally	inequívocamente
uneven	desigual
unexpected	inesperado
unexpectedly	inesperadamente
unfairly	injustamente
unfaithful	infiel
unfaithfully	infielmente
unfamiliar	desconocido
unfavorable	desfavorable
unfazed	imperturbable
unfeeling	insensible
unfinished	inconcluso
unforeseen	contingencias
unforgettable	inolvidable
unforgiving	implacable
unfortunate	desgraciado
unfortunately	desafortunadamente
unfounded	infundado
unfriendly	hostil
unfulfilled	incumplida
ungovernable	ingobernable
ungrateful	ingrato
unhappily	infelizmente
unhappiness	infelicidad
unhappy	infeliz
unhealthy	insalubre
unilateralism	unilateralismo
unimaginable	inimaginable
unimaginably	inimaginablemente
unintelligible	ininteligible
unity	unidad
unjustifiable	injustificable
unjustifiably	injustificadamente
unjustified	injustificado
unjust	injusto
unjustly	injustamente
unknown	desconocido
unlawful	ilegal
unlawfully	ilegalmente
unlawfulness	ilegalidad
unlimited	ilimitado
unlucky	desafortunado
unmoved	impasible
unnatural	antinatural
unnecessary	innecesario
unnerved	enervado
unnerve	enervar
unnerving	enervante
unnervingly	desconcertantemente
unobserved	desapercibido
unorthodox	heterodoxo
unorthodoxy	heterodoxia
unparalleled	incomparable
unpleasant	desagradable
unpleasantries	desagradables
unpopular	impopular
unpredictable	imprevisible
unprepared	desprevenido
unproductive	improductivo
unprofitable	improductivo
unquestionable	incuestionable
unquestionably	incuestionablemente
unravel	desvela
unraveled	desentrañado
unreachable	inalcanzable
unreadable	ilegible
unreal	irreal
unreasonable	irrazonable
unreasonably	excesivamente
unrelenting	implacable
unrelentingly	implacablemente
unresolved	irresoluto
unresponsive	insensible
unrest	disturbios
unrestricted	irrestricto
unrivaled	incomparable
unruly	revoltoso
unsafe	inseguro
unsatisfactory	insatisfactorio
unsavory	desagradable
unseemly	impropio
unselfish	altruista
unsettled	inestable
unsettle	trastornar
unsettling	inquietante
unsettlingly	perturbadoramente
unsound	defectuoso
unspeakable	indecible
unstable	inestable
unsteadily	inestablemente
unsteadiness	inestabilidad
unsteady	inestable
unsuccessful	infructuoso
unsupportive	insolidario
unsure	inseguro
unsuspecting	desprevenido
unsustainable	insostenible
untenable	insostenible
unthinkable	inconcebible
untimely	inoportuno
untrue	falso
untruthful	mentiroso
unusable	inutilizable
unusably	inutilizable
unuseable	inutilizable
unuseably	inutilizable
unusually	particularmente
unusual	raro
un-viewable	no-visible
unwarranted	injustificado
unwavering	inquebrantable
unwelcome	molesto
unwell	indispuesto
unwieldy	pesado
unwillingness	renuencia
unwilling	reacio
unwise	imprudente
unwisely	imprudentemente
unworkable	impracticable
unyielding	inflexible
upbeat	optimista
upgradable	actualizable
upgradeable	actualizable
upgraded	actualización
upheaval	convulsión
upheld	sostenida
uphold	defender
uplifting	inspirador
uplift	inspirar
upliftment	inspiración
uprising	levantamiento
uproar	estruendo
uproarious	estruendoso
uproariously	ruidosamente
uproot	desarraigar
upscale	lujo
upsets	trastornos
upsetting	molesto
upset	trastorno
urgent	urgente
usable	utilizable
useable	utilizable
useful	útil
useless	inútil
usurper	usurpador
usurp	usurpar
utterly	absolutamente
vagrant	vagabundo
vagueness	vaguedad
vague	vago
vainly	vanamente
vain	vano
valiantly	valientemente
valiant	valiente
valuable	valioso
vanity	vanidad
variety	variedad
vehemently	vehementemente
vehement	vehemente
venerate	venerar
vengeance	venganza
vengefully	vengativamente
vengeful	vengativo
venomously	venenosamente
venomous	venenoso
venom	veneno
vent	respiradero
verifiable	verificable
veritable	verdadero
versatile	versátil
versatility	versatilidad
vestiges	vestigios
vexation	vejación
vexing	irritante
vexingly	irritantemente
vex	vejar
vibrantly	vibrantemente
vibrant	vibrante
vibrated	vibrado
vibrates	vibra
vibrate	vibrar
vibrating	vibrando
vibration	vibración
vice	vicio
viciously	viciosamente
viciousness	crueldad
vicious	vicioso
victimize	victimizar
victorious	victorioso
victory	victoria
viewable	visible
vigilance	vigilancia
vigilant	vigilante
vileness	vileza
vile	vil
vilify	vilipendiar
villainously	vilmente
villainous	villano
villains	villanos
vindictively	vengativamente
vindictive	vengativo
violation	violación
violators	violadores
violator	violador
violently	violentamente
violent	violento
viper	víbora
virtue	bushido
virtuously	virtuosamente
virtuous	virtuoso
virulence	virulencia
virulently	virulentamente
virulent	virulento
visionary	visionario
vivacious	vivaz
vivid	vívido
vociferously	vociferantemente
vociferous	vociferante
volatile	volátil
volatility	volatilidad
vomited	vomitado
vomiting	vómitos
vomits	vómitos
vomit	vómito
vouch	atestiguar
vouchsafe	conceder
wail	gemido
wallow	revolcarse
wane	menguar
waning	menguante
warily	cautela
wariness	cautela
war-like	bélica
warlike	belicoso
warm	caliente
warmly	calurosamente
warmth	calor
warned	prevenido
warning	advertencia
warped	deformado
warp	urdimbre
wary	cauteloso
washed-out	desteñido
wasted	desaprovechado
wasteful	antieconómico
wastefulness	residuos
waste	residuos
wasting	perder
water-down	agua-down
watered-down	aguada
wayward	rebelde
weak	débil
weaken	débil
weakening	debilitación
weakness	debilidad
weaknesses	debilidades
wealthy	rico
weariness	cansancio
wearisome	aburrido
weary	cansado
wedge	cuña
weep	llorar
weird	extraño
weirdly	extrañamente
welcome	bienvenida
well-being	bienestar
wellbeing	bienestar
well	bien
well-mannered	educado
well-wishers	bienquerientes
wheedle	engatusar
whimper	gemido
whine	silbido
whining	gimoteo
whiny	llorón
whips	látigos
whoa	hala
wholesome	saludable
whooa	hala
whoooa	hala
whore	puta
whores	putas
wickedly	perversamente
wicked	malvado
wickedness	maldad
wieldy	manejable
wildly	salvajemente
wild	salvaje
wiles	engaños
willing	dispuesto
willingness	disposición
wilt	marchitar
wily	astuto
winnable	ganable
winner	ganador
winning	ganadora
wins	victorias
win	victoria
wisdom	sabiduría
wisely	prudentemente
wise	prudente
witty	ingenioso
wobbled	tambaleado
wobbles	bamboleos
wobble	tambalearse
woe	ay
woebegone	desconsolado
woeful	lamentable
woefully	lamentablemente
womanizer	mujeriego
womanizing	mujeriego
wonderfully	maravillosamente
wonderful	maravilloso
wonderously	maravillosamente
wonderous	maravillosa
wonder	preguntarse
wonders	maravillas
wondrous	maravilloso
won	ganó
woo	cortejar
workable	factible
worked	trabajado
works	obras
work	trabajo
world-famous	famosa
worn	usado
worriedly	preocupación
worried	preocupado
worrier	angustiado
worries	preocupaciones
worrisome	inquietante
worrying	angustioso
worryingly	preocupante
worry	preocuparse
worsen	exacerbar
worsening	empeoramiento
worse	peor
worst	peor
worthiness	mérito
worthlessly	indignamente
worthlessness	inutilidad
worth	valor
worthy	digno
wound	herida
wounds	heridas
wowed	sorprendió
wowing	sorprendente
wow	sorprender
wows	sorpresas
wrangle	reñir
wrath	ira
wreaked	causado
wreak	infligir
wreaks	apesta
wreck	naufragio
wrest	arrebatar
wrestle	luchar
wretch	desgraciado
wretchedly	miserablemente
wretched	miserable
wretchedness	miseria
wrinkle	arruga
wrinkled	arrugado
wrinkles	arrugas
wrip	pida
writhe	retorcerse
wrongful	ilegal
wrongly	erróneamente
wrong	mal
wrought	forjado
yawn	bostezo
yay	toma
youthful	juvenil
zapped	zapping
zaps	zapping
zap	zas
zeal	celo
zealot	fanático
zealous	celoso
zealously	celosamente
zenith	cenit
zest	entusiasmo
zippy	enérgico
zombie	zombi
-	-
very	muy
very	mucho
incredibly	increíblemente
absolutely	absolutamente
awfully	terriblemente
enormously	enormemente
extremely	extremadamente
horribly	horriblemente
seriously	seriamente
pretty	bastante
too	demasiado
really	realmente
most	más
more	más
-	-
no	no
not	no
can't	no
won't	no
doesn't no
don't	no
shouldn't	no
n't	no
didn't	no
couldn't	no
wouldn't	no
-	-
little	poco
enough	suficiente
enough	suficientemente
enough	bastante
enough	bastantes
-	-
can	puede
could	podía
might	puede
might	quizás
might	posiblemente
should	debería
